Wins,Losses,total_games,W/total_games,Wins_per_surface,Losses_per_surface,total_games_per_surface,W/total_games_per_surface,player_name,winner,loser,tourney name
0,4,4,0.0,0,0,0,,Daniel Elahi Galan,Daniel Elahi Galan,Leonardo Mayer,Davis Cup QLS R1: ARG vs COL
0,6,6,0.0,0,4,4,0.0,Leonardo Mayer,Daniel Elahi Galan,Leonardo Mayer,Davis Cup QLS R1: ARG vs COL
3,5,8,37.5,3,5,8,37.5,Jordan Thompson,Jordan Thompson,Thiago Monteiro,Davis Cup QLS R1: AUS vs BRA
6,6,12,50.0,1,2,3,33.333333333333336,Thiago Monteiro,Jordan Thompson,Thiago Monteiro,Davis Cup QLS R1: AUS vs BRA
2,6,8,25.0,2,6,8,25.0,Dennis Novak,Dennis Novak,Martin Cuevas,Davis Cup QLS R1: AUT vs URU
0,1,1,0.0,0,1,1,0.0,Martin Cuevas,Dennis Novak,Martin Cuevas,Davis Cup QLS R1: AUT vs URU
0,0,0,,0,0,0,,Ruben Bemelmans,Ruben Bemelmans,Attila Balazs,Davis Cup QLS R1: BEL vs HUN
4,2,6,66.66666666666667,4,2,6,66.66666666666667,Attila Balazs,Ruben Bemelmans,Attila Balazs,Davis Cup QLS R1: BEL vs HUN
0,2,2,0.0,0,2,2,0.0,Borna Gojo,Borna Gojo,Prajnesh Gunneswaran,Davis Cup QLS R1: CRO vs IND
1,3,4,25.0,1,3,4,25.0,Prajnesh Gunneswaran,Borna Gojo,Prajnesh Gunneswaran,Davis Cup QLS R1: CRO vs IND
5,1,6,83.33333333333333,0,0,0,,Jiri Vesely,Jiri Vesely,Jozef Kovalik,Davis Cup QLS R1: CZE vs SVK
1,3,4,25.0,1,2,3,33.333333333333336,Jozef Kovalik,Jiri Vesely,Jozef Kovalik,Davis Cup QLS R1: CZE vs SVK
6,7,13,46.15384615384615,6,7,13,46.15384615384615,Jan Lennard Struff,Jan Lennard Struff,Ilya Ivashka,Davis Cup QLS R1: GER vs BLR
2,3,5,40.0,2,3,5,40.0,Ilya Ivashka,Jan Lennard Struff,Ilya Ivashka,Davis Cup QLS R1: GER vs BLR
0,1,1,0.0,0,1,1,0.0,Emilio Gomez,Emilio Gomez,Go Soeda,Davis Cup QLS R1: JPN vs ECU
2,2,4,50.0,2,2,4,50.0,Go Soeda,Emilio Gomez,Go Soeda,Davis Cup QLS R1: JPN vs ECU
2,1,3,66.66666666666667,2,1,3,66.66666666666667,Robin Haase,Robin Haase,Mikhail Kukushkin,Davis Cup QLS R1: KAZ vs NED
2,6,8,25.0,2,6,8,25.0,Mikhail Kukushkin,Robin Haase,Mikhail Kukushkin,Davis Cup QLS R1: KAZ vs NED
4,5,9,44.44444444444444,4,5,9,44.44444444444444,Mikael Ymer,Mikael Ymer,Marcelo Tomas Barrios Vera,Davis Cup QLS R1: SWE vs CHI
1,1,2,50.0,0,0,0,,Marcelo Tomas Barrios Vera,Mikael Ymer,Marcelo Tomas Barrios Vera,Davis Cup QLS R1: SWE vs CHI
6,5,11,54.54545454545455,6,5,11,54.54545454545455,Reilly Opelka,Reilly Opelka,Denis Istomin,Davis Cup QLS R1: USA vs UZB
0,1,1,0.0,0,1,1,0.0,Denis Istomin,Reilly Opelka,Denis Istomin,Davis Cup QLS R1: USA vs UZB
0,5,5,0.0,0,5,5,0.0,Damir Dzumhur,Damir Dzumhur,Ruan Roelofse,Davis Cup WG1 PO: BIH vs RSA
0,0,0,,0,0,0,,Ruan Roelofse,Damir Dzumhur,Ruan Roelofse,Davis Cup WG1 PO: BIH vs RSA
2,5,7,28.571428571428573,2,4,6,33.333333333333336,Hugo Dellien,Hugo Dellien,Jose Hernandez,Davis Cup WG1 PO: BOL vs DOM
0,0,0,,0,0,0,,Jose Hernandez,Hugo Dellien,Jose Hernandez,Davis Cup WG1 PO: BOL vs DOM
0,0,0,,0,0,0,,Benjamin Hassan,Benjamin Hassan,Jirat Navasirisomboon,Davis Cup WG1 PO: LBN vs THA
0,0,0,,0,0,0,,Jirat Navasirisomboon,Benjamin Hassan,Jirat Navasirisomboon,Davis Cup WG1 PO: LBN vs THA
0,0,0,,0,0,0,,Frederico Ferreira Silva,Frederico Ferreira Silva,Laurynas Grigelis,Davis Cup WG1 PO: LTU vs POR
0,0,0,,0,0,0,,Laurynas Grigelis,Frederico Ferreira Silva,Laurynas Grigelis,Davis Cup WG1 PO: LTU vs POR
0,0,0,,0,0,0,,Patrik Niklas Salminen,Patrik Niklas Salminen,Manuel Sanchez,Davis Cup WG1 PO: MEX vs FIN
0,0,0,,0,0,0,,Manuel Sanchez,Patrik Niklas Salminen,Manuel Sanchez,Davis Cup WG1 PO: MEX vs FIN
0,3,3,0.0,0,3,3,0.0,Viktor Durasovic,Viktor Durasovic,Darian King,Davis Cup WG1 PO: NOR vs BAR
0,0,0,,0,0,0,,Darian King,Viktor Durasovic,Darian King,Davis Cup WG1 PO: NOR vs BAR
0,0,0,,0,0,0,,Aisam Ul Haq Qureshi,Aisam Ul Haq Qureshi,Nik Razborsek,Davis Cup WG1 PO: PAK vs SLO
0,0,0,,0,0,0,,Nik Razborsek,Aisam Ul Haq Qureshi,Nik Razborsek,Davis Cup WG1 PO: PAK vs SLO
1,1,2,50.0,1,1,2,50.0,Juan Pablo Varillas,Juan Pablo Varillas,Sandro Ehrat,Davis Cup WG1 PO: PER vs SUI
0,0,0,,0,0,0,,Sandro Ehrat,Juan Pablo Varillas,Sandro Ehrat,Davis Cup WG1 PO: PER vs SUI
0,0,0,,0,0,0,,Daniel Cukierman,Daniel Cukierman,Cem Ilkel,Davis Cup WG1 PO: TUR vs ISR
1,1,2,50.0,0,0,0,,Cem Ilkel,Daniel Cukierman,Cem Ilkel,Davis Cup WG1 PO: TUR vs ISR
0,0,0,,0,0,0,,Chun Hsin Tseng,Chun Hsin Tseng,Sergiy Stakhovsky,Davis Cup WG1 PO: UKR vs TPE
0,1,1,0.0,0,1,1,0.0,Sergiy Stakhovsky,Chun Hsin Tseng,Sergiy Stakhovsky,Davis Cup WG1 PO: UKR vs TPE
0,0,0,,0,0,0,,Finn Tearney,Finn Tearney,Jordi Munoz Abreu,Davis Cup WG1 PO: VEN vs NZL
0,0,0,,0,0,0,,Jordi Munoz Abreu,Finn Tearney,Jordi Munoz Abreu,Davis Cup WG1 PO: VEN vs NZL
2,1,3,66.66666666666667,2,1,3,66.66666666666667,Dimitar Kuzmanov,Dimitar Kuzmanov,Julian Saborio,Davis Cup WG2 PO: CRC vs BUL
0,0,0,,0,0,0,,Julian Saborio,Dimitar Kuzmanov,Julian Saborio,Davis Cup WG2 PO: CRC vs BUL
0,0,0,,0,0,0,,Mikael Torpegaard,Mikael Torpegaard,Quinton Vega,Davis Cup WG2 PO: DEN vs PUR
0,0,0,,0,0,0,,Quinton Vega,Mikael Torpegaard,Quinton Vega,Davis Cup WG2 PO: DEN vs PUR
0,0,0,,0,0,0,,Blaise Bicknell,Blaise Bicknell,Alberto Emmanuel Alvarado Larin,Davis Cup WG2 PO: ESA vs JAM
0,0,0,,0,0,0,,Alberto Emmanuel Alvarado Larin,Blaise Bicknell,Alberto Emmanuel Alvarado Larin,Davis Cup WG2 PO: ESA vs JAM
3,5,8,37.5,3,5,8,37.5,Nikoloz Basilashvili,Nikoloz Basilashvili,Vladimir Ivanov,Davis Cup WG2 PO: GEO vs EST
0,0,0,,0,0,0,,Vladimir Ivanov,Nikoloz Basilashvili,Vladimir Ivanov,Davis Cup WG2 PO: GEO vs EST
0,0,0,,0,0,0,,Wilfredo Gonzalez,Wilfredo Gonzalez,Aziz Dougaz,Davis Cup WG2 PO: GUA vs TUN
0,0,0,,0,0,0,,Aziz Dougaz,Wilfredo Gonzalez,Aziz Dougaz,Davis Cup WG2 PO: GUA vs TUN
0,0,0,,0,0,0,,Christopher Rungkat,Christopher Rungkat,Sheil Kotecha,Davis Cup WG2 PO: INA vs KEN
0,0,0,,0,0,0,,Sheil Kotecha,Christopher Rungkat,Sheil Kotecha,Davis Cup WG2 PO: INA vs KEN
0,2,2,0.0,0,2,2,0.0,Mohamed Safwat,Mohamed Safwat,Karlis Ozolins,Davis Cup WG2 PO: LAT vs EGY
0,0,0,,0,0,0,,Karlis Ozolins,Mohamed Safwat,Karlis Ozolins,Davis Cup WG2 PO: LAT vs EGY
0,0,0,,0,0,0,,Lamine Ouahab,Lamine Ouahab,Nam Hoang Ly,Davis Cup WG2 PO: MAR vs VIE
0,0,0,,0,0,0,,Nam Hoang Ly,Lamine Ouahab,Nam Hoang Ly,Davis Cup WG2 PO: MAR vs VIE
0,0,0,,0,0,0,,Adolfo Daniel Vallejo,Adolfo Daniel Vallejo,Sharmal Dissanayake,Davis Cup WG2 PO: PAR vs SRI
0,0,0,,0,0,0,,Sharmal Dissanayake,Adolfo Daniel Vallejo,Sharmal Dissanayake,Davis Cup WG2 PO: PAR vs SRI
16,6,22,72.72727272727273,0,0,0,,Stefanos Tsitsipas,Stefanos Tsitsipas,Alberto Lim,Davis Cup WG2 PO: PHI vs GRE
0,0,0,,0,0,0,,Alberto Lim,Stefanos Tsitsipas,Alberto Lim,Davis Cup WG2 PO: PHI vs GRE
1,1,2,50.0,1,1,2,50.0,Kacper Zuk,Kacper Zuk,Ching Lam,Davis Cup WG2 PO: POL vs HKG
0,0,0,,0,0,0,,Ching Lam,Kacper Zuk,Ching Lam,Davis Cup WG2 PO: POL vs HKG
0,0,0,,0,0,0,,Hazem Naw,Hazem Naw,Mehluli Don Ayanda Sibanda,Davis Cup WG2 PO: SYR vs ZIM
0,0,0,,0,0,0,,Mehluli Don Ayanda Sibanda,Hazem Naw,Mehluli Don Ayanda Sibanda,Davis Cup WG2 PO: SYR vs ZIM
6,6,12,50.0,6,4,10,60.0,Juan Ignacio Londero,Juan Ignacio Londero,Santiago Giraldo,Davis Cup QLS R1: ARG vs COL
0,1,1,0.0,0,0,0,,Santiago Giraldo,Juan Ignacio Londero,Santiago Giraldo,Davis Cup QLS R1: ARG vs COL
6,5,11,54.54545454545455,6,5,11,54.54545454545455,John Millman,John Millman,Thiago Seyboth Wild,Davis Cup QLS R1: AUS vs BRA
6,1,7,85.71428571428571,0,0,0,,Thiago Seyboth Wild,John Millman,Thiago Seyboth Wild,Davis Cup QLS R1: AUS vs BRA
5,9,14,35.714285714285715,1,5,6,16.666666666666668,Pablo Cuevas,Pablo Cuevas,Jurij Rodionov,Davis Cup QLS R1: AUT vs URU
0,0,0,,0,0,0,,Jurij Rodionov,Pablo Cuevas,Jurij Rodionov,Davis Cup QLS R1: AUT vs URU
5,5,10,50.0,0,0,0,,Marton Fucsovics,Marton Fucsovics,Kimmer Coppejans,Davis Cup QLS R1: BEL vs HUN
0,1,1,0.0,0,0,0,,Kimmer Coppejans,Marton Fucsovics,Kimmer Coppejans,Davis Cup QLS R1: BEL vs HUN
6,4,10,60.0,6,4,10,60.0,Marin Cilic,Marin Cilic,Ramkumar Ramanathan,Davis Cup QLS R1: CRO vs IND
0,1,1,0.0,0,1,1,0.0,Ramkumar Ramanathan,Marin Cilic,Ramkumar Ramanathan,Davis Cup QLS R1: CRO vs IND
0,1,1,0.0,0,0,0,,Lukas Rosol,Lukas Rosol,Andrej Martin,Davis Cup QLS R1: CZE vs SVK
3,4,7,42.857142857142854,3,4,7,42.857142857142854,Andrej Martin,Lukas Rosol,Andrej Martin,Davis Cup QLS R1: CZE vs SVK
7,3,10,70.0,7,3,10,70.0,Egor Gerasimov,Egor Gerasimov,Philipp Kohlschreiber,Davis Cup QLS R1: GER vs BLR
4,4,8,50.0,4,4,8,50.0,Philipp Kohlschreiber,Egor Gerasimov,Philipp Kohlschreiber,Davis Cup QLS R1: GER vs BLR
0,0,0,,0,0,0,,Roberto Quiroz,Roberto Quiroz,Yasutaka Uchiyama,Davis Cup QLS R1: JPN vs ECU
1,5,6,16.666666666666668,1,5,6,16.666666666666668,Yasutaka Uchiyama,Roberto Quiroz,Yasutaka Uchiyama,Davis Cup QLS R1: JPN vs ECU
9,8,17,52.94117647058823,9,8,17,52.94117647058823,Alexander Bublik,Alexander Bublik,Tallon Griekspoor,Davis Cup QLS R1: KAZ vs NED
0,3,3,0.0,0,3,3,0.0,Tallon Griekspoor,Alexander Bublik,Tallon Griekspoor,Davis Cup QLS R1: KAZ vs NED
2,2,4,50.0,1,1,2,50.0,Alejandro Tabilo,Alejandro Tabilo,Elias Ymer,Davis Cup QLS R1: SWE vs CHI
0,0,0,,0,0,0,,Elias Ymer,Alejandro Tabilo,Elias Ymer,Davis Cup QLS R1: SWE vs CHI
8,7,15,53.333333333333336,8,7,15,53.333333333333336,Taylor Fritz,Taylor Fritz,Sanjar Fayziev,Davis Cup QLS R1: USA vs UZB
0,0,0,,0,0,0,,Sanjar Fayziev,Taylor Fritz,Sanjar Fayziev,Davis Cup QLS R1: USA vs UZB
5,5,10,50.0,5,5,10,50.0,Lloyd Harris,Lloyd Harris,Mirza Basic,Davis Cup WG1 PO: BIH vs RSA
0,0,0,,0,0,0,,Mirza Basic,Lloyd Harris,Mirza Basic,Davis Cup WG1 PO: BIH vs RSA
0,0,0,,0,0,0,,Roberto Cid,Roberto Cid,Federico Zeballos,Davis Cup WG1 PO: BOL vs DOM
0,0,0,,0,0,0,,Federico Zeballos,Roberto Cid,Federico Zeballos,Davis Cup WG1 PO: BOL vs DOM
0,0,0,,0,0,0,,Wishaya Trongcharoenchaikul,Wishaya Trongcharoenchaikul,Hasan Ibrahim,Davis Cup WG1 PO: LBN vs THA
0,0,0,,0,0,0,,Hasan Ibrahim,Wishaya Trongcharoenchaikul,Hasan Ibrahim,Davis Cup WG1 PO: LBN vs THA
0,5,5,0.0,0,5,5,0.0,Joao Sousa,Joao Sousa,Julius Tverijonas,Davis Cup WG1 PO: LTU vs POR
0,0,0,,0,0,0,,Julius Tverijonas,Joao Sousa,Julius Tverijonas,Davis Cup WG1 PO: LTU vs POR
0,1,1,0.0,0,0,0,,Gerardo Lopez Villasenor,Gerardo Lopez Villasenor,Otto Virtanen,Davis Cup WG1 PO: MEX vs FIN
0,0,0,,0,0,0,,Otto Virtanen,Gerardo Lopez Villasenor,Otto Virtanen,Davis Cup WG1 PO: MEX vs FIN
10,5,15,66.66666666666667,2,3,5,40.0,Casper Ruud,Casper Ruud,Haydn Lewis,Davis Cup WG1 PO: NOR vs BAR
0,0,0,,0,0,0,,Haydn Lewis,Casper Ruud,Haydn Lewis,Davis Cup WG1 PO: NOR vs BAR
0,0,0,,0,0,0,,Aqeel Khan,Aqeel Khan,Blaz Kavcic,Davis Cup WG1 PO: PAK vs SLO
0,0,0,,0,0,0,,Blaz Kavcic,Aqeel Khan,Blaz Kavcic,Davis Cup WG1 PO: PAK vs SLO
0,3,3,0.0,0,0,0,,Henri Laaksonen,Henri Laaksonen,Nicolas Alvarez,Davis Cup WG1 PO: PER vs SUI
0,0,0,,0,0,0,,Nicolas Alvarez,Henri Laaksonen,Nicolas Alvarez,Davis Cup WG1 PO: PER vs SUI
0,0,0,,0,0,0,,Altug Celikbilek,Altug Celikbilek,Ben Patael,Davis Cup WG1 PO: TUR vs ISR
0,0,0,,0,0,0,,Ben Patael,Altug Celikbilek,Ben Patael,Davis Cup WG1 PO: TUR vs ISR
0,0,0,,0,0,0,,Tung Lin Wu,Tung Lin Wu,Illya Marchenko,Davis Cup WG1 PO: UKR vs TPE
0,0,0,,0,0,0,,Illya Marchenko,Tung Lin Wu,Illya Marchenko,Davis Cup WG1 PO: UKR vs TPE
0,0,0,,0,0,0,,Luis David Martinez,Luis David Martinez,Ajeet Rai,Davis Cup WG1 PO: VEN vs NZL
0,0,0,,0,0,0,,Ajeet Rai,Luis David Martinez,Ajeet Rai,Davis Cup WG1 PO: VEN vs NZL
0,0,0,,0,0,0,,Alexandar Lazarov,Alexandar Lazarov,Jesse Flores,Davis Cup WG2 PO: CRC vs BUL
0,0,0,,0,0,0,,Jesse Flores,Alexandar Lazarov,Jesse Flores,Davis Cup WG2 PO: CRC vs BUL
0,0,0,,0,0,0,,Marcelo Arevalo,Marcelo Arevalo,Rowland Phillips,Davis Cup WG2 PO: ESA vs JAM
0,0,0,,0,0,0,,Rowland Phillips,Marcelo Arevalo,Rowland Phillips,Davis Cup WG2 PO: ESA vs JAM
0,0,0,,0,0,0,,Kristjan Tamm,Kristjan Tamm,Aleksandre Metreveli,Davis Cup WG2 PO: GEO vs EST
1,2,3,33.333333333333336,1,2,3,33.333333333333336,Aleksandre Metreveli,Kristjan Tamm,Aleksandre Metreveli,Davis Cup WG2 PO: GEO vs EST
0,2,2,0.0,0,2,2,0.0,Malek Jaziri,Malek Jaziri,Franz Luna Lavidalie,Davis Cup WG2 PO: GUA vs TUN
0,0,0,,0,0,0,,Franz Luna Lavidalie,Malek Jaziri,Franz Luna Lavidalie,Davis Cup WG2 PO: GUA vs TUN
0,0,0,,0,0,0,,David Agung Susanto,David Agung Susanto,Ismael Changawa Ruwa Mzai,Davis Cup WG2 PO: INA vs KEN
0,0,0,,0,0,0,,Ismael Changawa Ruwa Mzai,David Agung Susanto,Ismael Changawa Ruwa Mzai,Davis Cup WG2 PO: INA vs KEN
2,2,4,50.0,2,2,4,50.0,Ernests Gulbis,Ernests Gulbis,Karim Mohamed Maamoun,Davis Cup WG2 PO: LAT vs EGY
0,0,0,,0,0,0,,Karim Mohamed Maamoun,Ernests Gulbis,Karim Mohamed Maamoun,Davis Cup WG2 PO: LAT vs EGY
0,0,0,,0,0,0,,Adam Moundir,Adam Moundir,Phuong Van Nguyen,Davis Cup WG2 PO: MAR vs VIE
0,0,0,,0,0,0,,Phuong Van Nguyen,Adam Moundir,Phuong Van Nguyen,Davis Cup WG2 PO: MAR vs VIE
0,0,0,,0,0,0,,Petros Tsitsipas,Petros Tsitsipas,Jeson Patrombon,Davis Cup WG2 PO: PHI vs GRE
0,0,0,,0,0,0,,Jeson Patrombon,Petros Tsitsipas,Jeson Patrombon,Davis Cup WG2 PO: PHI vs GRE
0,0,0,,0,0,0,,Jerzy Janowicz,Jerzy Janowicz,Pak Long Yeung,Davis Cup WG2 PO: POL vs HKG
0,0,0,,0,0,0,,Pak Long Yeung,Jerzy Janowicz,Pak Long Yeung,Davis Cup WG2 PO: POL vs HKG
0,0,0,,0,0,0,,Benjamin Lock,Benjamin Lock,Amer Naow,Davis Cup WG2 PO: SYR vs ZIM
0,0,0,,0,0,0,,Amer Naow,Benjamin Lock,Amer Naow,Davis Cup WG2 PO: SYR vs ZIM
1,4,5,20.0,1,0,1,100.0,Daniel Elahi Galan,Daniel Elahi Galan,Juan Ignacio Londero,Davis Cup QLS R1: ARG vs COL
7,6,13,53.84615384615385,7,4,11,63.63636363636363,Juan Ignacio Londero,Daniel Elahi Galan,Juan Ignacio Londero,Davis Cup QLS R1: ARG vs COL
7,5,12,58.333333333333336,7,5,12,58.333333333333336,John Millman,John Millman,Thiago Monteiro,Davis Cup QLS R1: AUS vs BRA
6,7,13,46.15384615384615,1,3,4,25.0,Thiago Monteiro,John Millman,Thiago Monteiro,Davis Cup QLS R1: AUS vs BRA
3,6,9,33.333333333333336,3,6,9,33.333333333333336,Dennis Novak,Dennis Novak,Pablo Cuevas,Davis Cup QLS R1: AUT vs URU
6,9,15,40.0,2,5,7,28.571428571428573,Pablo Cuevas,Dennis Novak,Pablo Cuevas,Davis Cup QLS R1: AUT vs URU
4,3,7,57.142857142857146,4,3,7,57.142857142857146,Attila Balazs,Attila Balazs,Kimmer Coppejans,Davis Cup QLS R1: BEL vs HUN
0,2,2,0.0,0,1,1,0.0,Kimmer Coppejans,Attila Balazs,Kimmer Coppejans,Davis Cup QLS R1: BEL vs HUN
7,4,11,63.63636363636363,7,4,11,63.63636363636363,Marin Cilic,Marin Cilic,Sumit Nagal,Davis Cup QLS R1: CRO vs IND
0,1,1,0.0,0,1,1,0.0,Sumit Nagal,Marin Cilic,Sumit Nagal,Davis Cup QLS R1: CRO vs IND
6,1,7,85.71428571428571,1,0,1,100.0,Jiri Vesely,Jiri Vesely,Andrej Martin,Davis Cup QLS R1: CZE vs SVK
3,5,8,37.5,3,5,8,37.5,Andrej Martin,Jiri Vesely,Andrej Martin,Davis Cup QLS R1: CZE vs SVK
7,7,14,50.0,7,7,14,50.0,Jan Lennard Struff,Jan Lennard Struff,Egor Gerasimov,Davis Cup QLS R1: GER vs BLR
8,3,11,72.72727272727273,8,3,11,72.72727272727273,Egor Gerasimov,Jan Lennard Struff,Egor Gerasimov,Davis Cup QLS R1: GER vs BLR
10,8,18,55.55555555555556,10,8,18,55.55555555555556,Alexander Bublik,Alexander Bublik,Robin Haase,Davis Cup QLS R1: KAZ vs NED
3,1,4,75.0,3,1,4,75.0,Robin Haase,Alexander Bublik,Robin Haase,Davis Cup QLS R1: KAZ vs NED
5,5,10,50.0,5,5,10,50.0,Mikael Ymer,Mikael Ymer,Alejandro Tabilo,Davis Cup QLS R1: SWE vs CHI
3,2,5,60.0,2,1,3,66.66666666666667,Alejandro Tabilo,Mikael Ymer,Alejandro Tabilo,Davis Cup QLS R1: SWE vs CHI
8,5,13,61.53846153846154,8,5,13,61.53846153846154,Tommy Paul,Tommy Paul,Denis Istomin,Davis Cup QLS R1: USA vs UZB
0,2,2,0.0,0,2,2,0.0,Denis Istomin,Tommy Paul,Denis Istomin,Davis Cup QLS R1: USA vs UZB
1,5,6,16.666666666666668,1,5,6,16.666666666666668,Damir Dzumhur,Damir Dzumhur,Lloyd Harris,Davis Cup WG1 PO: BIH vs RSA
6,5,11,54.54545454545455,6,5,11,54.54545454545455,Lloyd Harris,Damir Dzumhur,Lloyd Harris,Davis Cup WG1 PO: BIH vs RSA
3,5,8,37.5,3,4,7,42.857142857142854,Hugo Dellien,Hugo Dellien,Roberto Cid,Davis Cup WG1 PO: BOL vs DOM
1,0,1,100.0,1,0,1,100.0,Roberto Cid,Hugo Dellien,Roberto Cid,Davis Cup WG1 PO: BOL vs DOM
1,0,1,100.0,1,0,1,100.0,Benjamin Hassan,Benjamin Hassan,Wishaya Trongcharoenchaikul,Davis Cup WG1 PO: LBN vs THA
1,0,1,100.0,1,0,1,100.0,Wishaya Trongcharoenchaikul,Benjamin Hassan,Wishaya Trongcharoenchaikul,Davis Cup WG1 PO: LBN vs THA
4,2,6,66.66666666666667,0,0,0,,Pedro Sousa,Pedro Sousa,Laurynas Grigelis,Davis Cup WG1 PO: LTU vs POR
0,1,1,0.0,0,1,1,0.0,Laurynas Grigelis,Pedro Sousa,Laurynas Grigelis,Davis Cup WG1 PO: LTU vs POR
1,1,2,50.0,1,0,1,100.0,Gerardo Lopez Villasenor,Gerardo Lopez Villasenor,Harri Heliovaara,Davis Cup WG1 PO: MEX vs FIN
0,0,0,,0,0,0,,Harri Heliovaara,Gerardo Lopez Villasenor,Harri Heliovaara,Davis Cup WG1 PO: MEX vs FIN
0,0,0,,0,0,0,,Lukas Hellum Lilleengen,Lukas Hellum Lilleengen,Kaipo Marshall,Davis Cup WG1 PO: NOR vs BAR
0,0,0,,0,0,0,,Kaipo Marshall,Lukas Hellum Lilleengen,Kaipo Marshall,Davis Cup WG1 PO: NOR vs BAR
2,1,3,66.66666666666667,2,1,3,66.66666666666667,Juan Pablo Varillas,Juan Pablo Varillas,Henri Laaksonen,Davis Cup WG1 PO: PER vs SUI
1,3,4,25.0,1,0,1,100.0,Henri Laaksonen,Juan Pablo Varillas,Henri Laaksonen,Davis Cup WG1 PO: PER vs SUI
0,0,0,,0,0,0,,Edan Leshem,Edan Leshem,Cem Ilkel,Davis Cup WG1 PO: TUR vs ISR
1,2,3,33.333333333333336,0,1,1,0.0,Cem Ilkel,Edan Leshem,Cem Ilkel,Davis Cup WG1 PO: TUR vs ISR
0,2,2,0.0,0,2,2,0.0,Sergiy Stakhovsky,Sergiy Stakhovsky,Tung Lin Wu,Davis Cup WG1 PO: UKR vs TPE
1,0,1,100.0,1,0,1,100.0,Tung Lin Wu,Sergiy Stakhovsky,Tung Lin Wu,Davis Cup WG1 PO: UKR vs TPE
0,0,0,,0,0,0,,Jose Rubin Statham,Jose Rubin Statham,Brandon Perez,Davis Cup WG1 PO: VEN vs NZL
0,0,0,,0,0,0,,Brandon Perez,Jose Rubin Statham,Brandon Perez,Davis Cup WG1 PO: VEN vs NZL
3,1,4,75.0,3,1,4,75.0,Dimitar Kuzmanov,Dimitar Kuzmanov,Jesse Flores,Davis Cup WG2 PO: CRC vs BUL
0,1,1,0.0,0,1,1,0.0,Jesse Flores,Dimitar Kuzmanov,Jesse Flores,Davis Cup WG2 PO: CRC vs BUL
1,0,1,100.0,1,0,1,100.0,Marcelo Arevalo,Marcelo Arevalo,Blaise Bicknell,Davis Cup WG2 PO: ESA vs JAM
1,0,1,100.0,1,0,1,100.0,Blaise Bicknell,Marcelo Arevalo,Blaise Bicknell,Davis Cup WG2 PO: ESA vs JAM
1,0,1,100.0,1,0,1,100.0,Kristjan Tamm,Kristjan Tamm,Zura Tkemaladze,Davis Cup WG2 PO: GEO vs EST
0,0,0,,0,0,0,,Zura Tkemaladze,Kristjan Tamm,Zura Tkemaladze,Davis Cup WG2 PO: GEO vs EST
1,2,3,33.333333333333336,1,2,3,33.333333333333336,Malek Jaziri,Malek Jaziri,Wilfredo Gonzalez,Davis Cup WG2 PO: GUA vs TUN
1,0,1,100.0,1,0,1,100.0,Wilfredo Gonzalez,Malek Jaziri,Wilfredo Gonzalez,Davis Cup WG2 PO: GUA vs TUN
0,0,0,,0,0,0,,Gunawan Trismuwantara,Gunawan Trismuwantara,Kevin Cheruiyot,Davis Cup WG2 PO: INA vs KEN
0,0,0,,0,0,0,,Kevin Cheruiyot,Gunawan Trismuwantara,Kevin Cheruiyot,Davis Cup WG2 PO: INA vs KEN
3,2,5,60.0,3,2,5,60.0,Ernests Gulbis,Ernests Gulbis,Mohamed Safwat,Davis Cup WG2 PO: LAT vs EGY
1,2,3,33.333333333333336,1,2,3,33.333333333333336,Mohamed Safwat,Ernests Gulbis,Mohamed Safwat,Davis Cup WG2 PO: LAT vs EGY
1,0,1,100.0,1,0,1,100.0,Adolfo Daniel Vallejo,Adolfo Daniel Vallejo,Thehan Sanjaya Wijemanne,Davis Cup WG2 PO: PAR vs SRI
0,0,0,,0,0,0,,Thehan Sanjaya Wijemanne,Adolfo Daniel Vallejo,Thehan Sanjaya Wijemanne,Davis Cup WG2 PO: PAR vs SRI
17,6,23,73.91304347826087,1,0,1,100.0,Stefanos Tsitsipas,Stefanos Tsitsipas,Jeson Patrombon,Davis Cup WG2 PO: PHI vs GRE
0,1,1,0.0,0,1,1,0.0,Jeson Patrombon,Stefanos Tsitsipas,Jeson Patrombon,Davis Cup WG2 PO: PHI vs GRE
0,0,0,,0,0,0,,Maks Kasnikowski,Maks Kasnikowski,Wai Yu Kai,Davis Cup WG2 PO: POL vs HKG
0,0,0,,0,0,0,,Wai Yu Kai,Maks Kasnikowski,Wai Yu Kai,Davis Cup WG2 PO: POL vs HKG
1,0,1,100.0,1,0,1,100.0,Benjamin Lock,Benjamin Lock,Hazem Naw,Davis Cup WG2 PO: SYR vs ZIM
1,0,1,100.0,1,0,1,100.0,Hazem Naw,Benjamin Lock,Hazem Naw,Davis Cup WG2 PO: SYR vs ZIM
6,5,11,54.54545454545455,1,0,1,100.0,Marton Fucsovics,Marton Fucsovics,Ruben Bemelmans,Davis Cup QLS R1: BEL vs HUN
1,0,1,100.0,1,0,1,100.0,Ruben Bemelmans,Marton Fucsovics,Ruben Bemelmans,Davis Cup QLS R1: BEL vs HUN
1,2,3,33.333333333333336,1,2,3,33.333333333333336,Dominik Koepfer,Dominik Koepfer,Daniil Ostapenkov,Davis Cup QLS R1: GER vs BLR
0,0,0,,0,0,0,,Daniil Ostapenkov,Dominik Koepfer,Daniil Ostapenkov,Davis Cup QLS R1: GER vs BLR
0,1,1,0.0,0,1,1,0.0,Otto Virtanen,Otto Virtanen,Manuel Sanchez,Davis Cup WG1 PO: MEX vs FIN
0,1,1,0.0,0,1,1,0.0,Manuel Sanchez,Otto Virtanen,Manuel Sanchez,Davis Cup WG1 PO: MEX vs FIN
0,1,1,0.0,0,1,1,0.0,Illya Marchenko,Illya Marchenko,Chun Hsin Tseng,Davis Cup WG1 PO: UKR vs TPE
1,0,1,100.0,1,0,1,100.0,Chun Hsin Tseng,Illya Marchenko,Chun Hsin Tseng,Davis Cup WG1 PO: UKR vs TPE
0,0,0,,0,0,0,,Alexander Donski,Alexander Donski,Rodrigo Crespo Piedra,Davis Cup WG2 PO: CRC vs BUL
0,0,0,,0,0,0,,Rodrigo Crespo Piedra,Alexander Donski,Rodrigo Crespo Piedra,Davis Cup WG2 PO: CRC vs BUL
0,0,0,,0,0,0,,Holger Rune,Holger Rune,Quinton Vega,Davis Cup WG2 PO: DEN vs PUR
0,1,1,0.0,0,1,1,0.0,Quinton Vega,Holger Rune,Quinton Vega,Davis Cup WG2 PO: DEN vs PUR
0,0,0,,0,0,0,,Daniil Glinka,Daniil Glinka,Nikoloz Davlianidze,Davis Cup WG2 PO: GEO vs EST
0,0,0,,0,0,0,,Nikoloz Davlianidze,Daniil Glinka,Nikoloz Davlianidze,Davis Cup WG2 PO: GEO vs EST
0,0,0,,0,0,0,,Robert Strombachs,Robert Strombachs,Amr Elsayed Abdou Ahmed Mohamed,Davis Cup WG2 PO: LAT vs EGY
0,0,0,,0,0,0,,Amr Elsayed Abdou Ahmed Mohamed,Robert Strombachs,Amr Elsayed Abdou Ahmed Mohamed,Davis Cup WG2 PO: LAT vs EGY
1,0,1,100.0,1,0,1,100.0,Petros Tsitsipas,Petros Tsitsipas,Eric Jr. Olivarez,Davis Cup WG2 PO: PHI vs GRE
0,0,0,,0,0,0,,Eric Jr. Olivarez,Petros Tsitsipas,Eric Jr. Olivarez,Davis Cup WG2 PO: PHI vs GRE
0,0,0,,0,0,0,,Filip Krajinovic,Filip Krajinovic,Salvatore Caruso,Cincinnati Masters
0,0,0,,0,0,0,,Salvatore Caruso,Filip Krajinovic,Salvatore Caruso,Cincinnati Masters
0,0,0,,0,0,0,,Marton Fucsovics,Marton Fucsovics,Norbert Gombos,Cincinnati Masters
0,0,0,,0,0,0,,Norbert Gombos,Marton Fucsovics,Norbert Gombos,Cincinnati Masters
0,0,0,,0,0,0,,Grigor Dimitrov,Grigor Dimitrov,Ugo Humbert,Cincinnati Masters
0,0,0,,0,0,0,,Ugo Humbert,Grigor Dimitrov,Ugo Humbert,Cincinnati Masters
0,0,0,,0,0,0,,Daniel Evans,Daniel Evans,Andrey Rublev,Cincinnati Masters
0,0,0,,0,0,0,,Andrey Rublev,Daniel Evans,Andrey Rublev,Cincinnati Masters
0,0,0,,0,0,0,,Milos Raonic,Milos Raonic,Sam Querrey,Cincinnati Masters
0,0,0,,0,0,0,,Sam Querrey,Milos Raonic,Sam Querrey,Cincinnati Masters
0,0,0,,0,0,0,,Andy Murray,Andy Murray,Frances Tiafoe,Cincinnati Masters
0,0,0,,0,0,0,,Frances Tiafoe,Andy Murray,Frances Tiafoe,Cincinnati Masters
0,0,0,,0,0,0,,Kevin Anderson,Kevin Anderson,Kyle Edmund,Cincinnati Masters
0,0,0,,0,0,0,,Kyle Edmund,Kevin Anderson,Kyle Edmund,Cincinnati Masters
0,0,0,,0,0,0,,John Millman,John Millman,Adrian Mannarino,Cincinnati Masters
0,0,0,,0,0,0,,Adrian Mannarino,John Millman,Adrian Mannarino,Cincinnati Masters
0,0,0,,0,0,0,,John Isner,John Isner,Hubert Hurkacz,Cincinnati Masters
0,0,0,,0,0,0,,Hubert Hurkacz,John Isner,Hubert Hurkacz,Cincinnati Masters
0,0,0,,0,0,0,,Diego Schwartzman,Diego Schwartzman,Casper Ruud,Cincinnati Masters
0,0,0,,0,0,0,,Casper Ruud,Diego Schwartzman,Casper Ruud,Cincinnati Masters
0,0,0,,0,0,0,,Reilly Opelka,Reilly Opelka,Cameron Norrie,Cincinnati Masters
0,0,0,,0,0,0,,Cameron Norrie,Reilly Opelka,Cameron Norrie,Cincinnati Masters
0,0,0,,0,0,0,,Emil Ruusuvuori,Emil Ruusuvuori,Sebastian Korda,Cincinnati Masters
0,0,0,,0,0,0,,Sebastian Korda,Emil Ruusuvuori,Sebastian Korda,Cincinnati Masters
0,0,0,,0,0,0,,Richard Gasquet,Richard Gasquet,J.J. Wolf,Cincinnati Masters
0,0,0,,0,0,0,,J.J. Wolf,Richard Gasquet,J.J. Wolf,Cincinnati Masters
0,0,0,,0,0,0,,Pablo Carreno Busta,Pablo Carreno Busta,Dusan Lajovic,Cincinnati Masters
0,0,0,,0,0,0,,Dusan Lajovic,Pablo Carreno Busta,Dusan Lajovic,Cincinnati Masters
0,0,0,,0,0,0,,Karen Khachanov,Karen Khachanov,Alexander Bublik,Cincinnati Masters
0,0,0,,0,0,0,,Alexander Bublik,Karen Khachanov,Alexander Bublik,Cincinnati Masters
0,0,0,,0,0,0,,Aljaz Bedene,Aljaz Bedene,Christian Garin,Cincinnati Masters
0,0,0,,0,0,0,,Christian Garin,Aljaz Bedene,Christian Garin,Cincinnati Masters
0,0,0,,0,0,0,,Taylor Fritz,Taylor Fritz,Lloyd Harris,Cincinnati Masters
0,0,0,,0,0,0,,Lloyd Harris,Taylor Fritz,Lloyd Harris,Cincinnati Masters
0,0,0,,0,0,0,,Marcos Giron,Marcos Giron,Mackenzie McDonald,Cincinnati Masters
0,0,0,,0,0,0,,Mackenzie McDonald,Marcos Giron,Mackenzie McDonald,Cincinnati Masters
0,0,0,,0,0,0,,Borna Coric,Borna Coric,Benoit Paire,Cincinnati Masters
0,0,0,,0,0,0,,Benoit Paire,Borna Coric,Benoit Paire,Cincinnati Masters
0,0,0,,0,0,0,,Jan Lennard Struff,Jan Lennard Struff,Alex De Minaur,Cincinnati Masters
0,0,0,,0,0,0,,Alex De Minaur,Jan Lennard Struff,Alex De Minaur,Cincinnati Masters
0,0,0,,0,0,0,,Denis Shapovalov,Denis Shapovalov,Marin Cilic,Cincinnati Masters
0,0,0,,0,0,0,,Marin Cilic,Denis Shapovalov,Marin Cilic,Cincinnati Masters
0,0,0,,0,0,0,,Felix Auger Aliassime,Felix Auger Aliassime,Nikoloz Basilashvili,Cincinnati Masters
0,0,0,,0,0,0,,Nikoloz Basilashvili,Felix Auger Aliassime,Nikoloz Basilashvili,Cincinnati Masters
0,0,0,,0,0,0,,Tennys Sandgren,Tennys Sandgren,Lorenzo Sonego,Cincinnati Masters
0,0,0,,0,0,0,,Lorenzo Sonego,Tennys Sandgren,Lorenzo Sonego,Cincinnati Masters
0,0,0,,0,0,0,,Ricardas Berankis,Ricardas Berankis,Tommy Paul,Cincinnati Masters
0,0,0,,0,0,0,,Tommy Paul,Ricardas Berankis,Tommy Paul,Cincinnati Masters
1,0,1,100.0,1,0,1,100.0,Filip Krajinovic,Filip Krajinovic,Dominic Thiem,Cincinnati Masters
0,0,0,,0,0,0,,Dominic Thiem,Filip Krajinovic,Dominic Thiem,Cincinnati Masters
1,0,1,100.0,1,0,1,100.0,Marton Fucsovics,Marton Fucsovics,Grigor Dimitrov,Cincinnati Masters
1,0,1,100.0,1,0,1,100.0,Grigor Dimitrov,Marton Fucsovics,Grigor Dimitrov,Cincinnati Masters
1,0,1,100.0,1,0,1,100.0,Milos Raonic,Milos Raonic,Daniel Evans,Cincinnati Masters
1,0,1,100.0,1,0,1,100.0,Daniel Evans,Milos Raonic,Daniel Evans,Cincinnati Masters
1,0,1,100.0,1,0,1,100.0,Andy Murray,Andy Murray,Alexander Zverev,Cincinnati Masters
0,0,0,,0,0,0,,Alexander Zverev,Andy Murray,Alexander Zverev,Cincinnati Masters
0,0,0,,0,0,0,,Stefanos Tsitsipas,Stefanos Tsitsipas,Kevin Anderson,Cincinnati Masters
1,0,1,100.0,1,0,1,100.0,Kevin Anderson,Stefanos Tsitsipas,Kevin Anderson,Cincinnati Masters
1,0,1,100.0,1,0,1,100.0,John Isner,John Isner,John Millman,Cincinnati Masters
1,0,1,100.0,1,0,1,100.0,John Millman,John Isner,John Millman,Cincinnati Masters
1,0,1,100.0,1,0,1,100.0,Reilly Opelka,Reilly Opelka,Diego Schwartzman,Cincinnati Masters
1,0,1,100.0,1,0,1,100.0,Diego Schwartzman,Reilly Opelka,Diego Schwartzman,Cincinnati Masters
0,0,0,,0,0,0,,Matteo Berrettini,Matteo Berrettini,Emil Ruusuvuori,Cincinnati Masters
1,0,1,100.0,1,0,1,100.0,Emil Ruusuvuori,Matteo Berrettini,Emil Ruusuvuori,Cincinnati Masters
0,0,0,,0,0,0,,Roberto Bautista Agut,Roberto Bautista Agut,Richard Gasquet,Cincinnati Masters
1,0,1,100.0,1,0,1,100.0,Richard Gasquet,Roberto Bautista Agut,Richard Gasquet,Cincinnati Masters
1,0,1,100.0,1,0,1,100.0,Karen Khachanov,Karen Khachanov,Pablo Carreno Busta,Cincinnati Masters
1,0,1,100.0,1,0,1,100.0,Pablo Carreno Busta,Karen Khachanov,Pablo Carreno Busta,Cincinnati Masters
1,0,1,100.0,1,0,1,100.0,Aljaz Bedene,Aljaz Bedene,Taylor Fritz,Cincinnati Masters
1,0,1,100.0,1,0,1,100.0,Taylor Fritz,Aljaz Bedene,Taylor Fritz,Cincinnati Masters
0,0,0,,0,0,0,,Daniil Medvedev,Daniil Medvedev,Marcos Giron,Cincinnati Masters
1,0,1,100.0,1,0,1,100.0,Marcos Giron,Daniil Medvedev,Marcos Giron,Cincinnati Masters
0,0,0,,0,0,0,,David Goffin,David Goffin,Borna Coric,Cincinnati Masters
1,0,1,100.0,1,0,1,100.0,Borna Coric,David Goffin,Borna Coric,Cincinnati Masters
1,0,1,100.0,1,0,1,100.0,Jan Lennard Struff,Jan Lennard Struff,Denis Shapovalov,Cincinnati Masters
1,0,1,100.0,1,0,1,100.0,Denis Shapovalov,Jan Lennard Struff,Denis Shapovalov,Cincinnati Masters
1,0,1,100.0,1,0,1,100.0,Tennys Sandgren,Tennys Sandgren,Felix Auger Aliassime,Cincinnati Masters
1,0,1,100.0,1,0,1,100.0,Felix Auger Aliassime,Tennys Sandgren,Felix Auger Aliassime,Cincinnati Masters
0,0,0,,0,0,0,,Novak Djokovic,Novak Djokovic,Ricardas Berankis,Cincinnati Masters
1,0,1,100.0,1,0,1,100.0,Ricardas Berankis,Novak Djokovic,Ricardas Berankis,Cincinnati Masters
2,0,2,100.0,2,0,2,100.0,Filip Krajinovic,Filip Krajinovic,Marton Fucsovics,Cincinnati Masters
2,0,2,100.0,2,0,2,100.0,Marton Fucsovics,Filip Krajinovic,Marton Fucsovics,Cincinnati Masters
2,0,2,100.0,2,0,2,100.0,Milos Raonic,Milos Raonic,Andy Murray,Cincinnati Masters
2,0,2,100.0,2,0,2,100.0,Andy Murray,Milos Raonic,Andy Murray,Cincinnati Masters
1,0,1,100.0,1,0,1,100.0,Stefanos Tsitsipas,Stefanos Tsitsipas,John Isner,Cincinnati Masters
2,0,2,100.0,2,0,2,100.0,John Isner,Stefanos Tsitsipas,John Isner,Cincinnati Masters
2,0,2,100.0,2,0,2,100.0,Reilly Opelka,Reilly Opelka,Matteo Berrettini,Cincinnati Masters
1,0,1,100.0,1,0,1,100.0,Matteo Berrettini,Reilly Opelka,Matteo Berrettini,Cincinnati Masters
1,0,1,100.0,1,0,1,100.0,Roberto Bautista Agut,Roberto Bautista Agut,Karen Khachanov,Cincinnati Masters
2,0,2,100.0,2,0,2,100.0,Karen Khachanov,Roberto Bautista Agut,Karen Khachanov,Cincinnati Masters
1,0,1,100.0,1,0,1,100.0,Daniil Medvedev,Daniil Medvedev,Aljaz Bedene,Cincinnati Masters
2,0,2,100.0,2,0,2,100.0,Aljaz Bedene,Daniil Medvedev,Aljaz Bedene,Cincinnati Masters
2,0,2,100.0,2,0,2,100.0,Jan Lennard Struff,Jan Lennard Struff,David Goffin,Cincinnati Masters
1,0,1,100.0,1,0,1,100.0,David Goffin,Jan Lennard Struff,David Goffin,Cincinnati Masters
1,0,1,100.0,1,0,1,100.0,Novak Djokovic,Novak Djokovic,Tennys Sandgren,Cincinnati Masters
2,0,2,100.0,2,0,2,100.0,Tennys Sandgren,Novak Djokovic,Tennys Sandgren,Cincinnati Masters
3,0,3,100.0,3,0,3,100.0,Milos Raonic,Milos Raonic,Filip Krajinovic,Cincinnati Masters
3,0,3,100.0,3,0,3,100.0,Filip Krajinovic,Milos Raonic,Filip Krajinovic,Cincinnati Masters
2,0,2,100.0,2,0,2,100.0,Stefanos Tsitsipas,Stefanos Tsitsipas,Reilly Opelka,Cincinnati Masters
3,0,3,100.0,3,0,3,100.0,Reilly Opelka,Stefanos Tsitsipas,Reilly Opelka,Cincinnati Masters
2,0,2,100.0,2,0,2,100.0,Roberto Bautista Agut,Roberto Bautista Agut,Daniil Medvedev,Cincinnati Masters
2,0,2,100.0,2,0,2,100.0,Daniil Medvedev,Roberto Bautista Agut,Daniil Medvedev,Cincinnati Masters
2,0,2,100.0,2,0,2,100.0,Novak Djokovic,Novak Djokovic,Jan Lennard Struff,Cincinnati Masters
3,0,3,100.0,3,0,3,100.0,Jan Lennard Struff,Novak Djokovic,Jan Lennard Struff,Cincinnati Masters
4,0,4,100.0,4,0,4,100.0,Milos Raonic,Milos Raonic,Stefanos Tsitsipas,Cincinnati Masters
3,0,3,100.0,3,0,3,100.0,Stefanos Tsitsipas,Milos Raonic,Stefanos Tsitsipas,Cincinnati Masters
3,0,3,100.0,3,0,3,100.0,Novak Djokovic,Novak Djokovic,Roberto Bautista Agut,Cincinnati Masters
3,0,3,100.0,3,0,3,100.0,Roberto Bautista Agut,Novak Djokovic,Roberto Bautista Agut,Cincinnati Masters
4,0,4,100.0,4,0,4,100.0,Novak Djokovic,Novak Djokovic,Milos Raonic,Cincinnati Masters
5,0,5,100.0,5,0,5,100.0,Milos Raonic,Novak Djokovic,Milos Raonic,Cincinnati Masters
5,0,5,100.0,5,0,5,100.0,Novak Djokovic,Novak Djokovic,Damir Dzumhur,Us Open
0,0,0,,0,0,0,,Damir Dzumhur,Novak Djokovic,Damir Dzumhur,Us Open
0,1,1,0.0,0,1,1,0.0,Kyle Edmund,Kyle Edmund,Alexander Bublik,Us Open
0,1,1,0.0,0,1,1,0.0,Alexander Bublik,Kyle Edmund,Alexander Bublik,Us Open
0,0,0,,0,0,0,,Michael Mmoh,Michael Mmoh,Joao Sousa,Us Open
0,0,0,,0,0,0,,Joao Sousa,Michael Mmoh,Joao Sousa,Us Open
3,1,4,75.0,3,1,4,75.0,Jan Lennard Struff,Jan Lennard Struff,Pedro Martinez,Us Open
0,0,0,,0,0,0,,Pedro Martinez,Jan Lennard Struff,Pedro Martinez,Us Open
1,1,2,50.0,1,1,2,50.0,Pablo Carreno Busta,Pablo Carreno Busta,Yasutaka Uchiyama,Us Open
0,0,0,,0,0,0,,Yasutaka Uchiyama,Pablo Carreno Busta,Yasutaka Uchiyama,Us Open
0,0,0,,0,0,0,,Mitchell Krueger,Mitchell Krueger,Pedro Sousa,Us Open
0,0,0,,0,0,0,,Pedro Sousa,Mitchell Krueger,Pedro Sousa,Us Open
1,1,2,50.0,1,1,2,50.0,Ricardas Berankis,Ricardas Berankis,Federico Gaio,Us Open
0,0,0,,0,0,0,,Federico Gaio,Ricardas Berankis,Federico Gaio,Us Open
0,0,0,,0,0,0,,Steve Johnson,Steve Johnson,John Isner,Us Open
2,1,3,66.66666666666667,2,1,3,66.66666666666667,John Isner,Steve Johnson,John Isner,Us Open
1,1,2,50.0,1,1,2,50.0,Denis Shapovalov,Denis Shapovalov,Sebastian Korda,Us Open
0,1,1,0.0,0,1,1,0.0,Sebastian Korda,Denis Shapovalov,Sebastian Korda,Us Open
0,0,0,,0,0,0,,Soon Woo Kwon,Soon Woo Kwon,Thai Son Kwiatkowski,Us Open
0,0,0,,0,0,0,,Thai Son Kwiatkowski,Soon Woo Kwon,Thai Son Kwiatkowski,Us Open
0,0,0,,0,0,0,,Gilles Simon,Gilles Simon,Mohamed Safwat,Us Open
0,0,0,,0,0,0,,Mohamed Safwat,Gilles Simon,Mohamed Safwat,Us Open
1,1,2,50.0,1,1,2,50.0,Taylor Fritz,Taylor Fritz,Dominik Koepfer,Us Open
0,0,0,,0,0,0,,Dominik Koepfer,Taylor Fritz,Dominik Koepfer,Us Open
3,1,4,75.0,3,1,4,75.0,Filip Krajinovic,Filip Krajinovic,Mikael Ymer,Us Open
0,0,0,,0,0,0,,Mikael Ymer,Filip Krajinovic,Mikael Ymer,Us Open
1,1,2,50.0,1,1,2,50.0,Marcos Giron,Marcos Giron,Marc Polmans,Us Open
0,0,0,,0,0,0,,Marc Polmans,Marcos Giron,Marc Polmans,Us Open
0,1,1,0.0,0,1,1,0.0,Lloyd Harris,Lloyd Harris,Marco Cecchinato,Us Open
0,0,0,,0,0,0,,Marco Cecchinato,Lloyd Harris,Marco Cecchinato,Us Open
1,1,2,50.0,1,1,2,50.0,David Goffin,David Goffin,Reilly Opelka,Us Open
3,1,4,75.0,3,1,4,75.0,Reilly Opelka,David Goffin,Reilly Opelka,Us Open
3,1,4,75.0,3,1,4,75.0,Stefanos Tsitsipas,Stefanos Tsitsipas,Albert Ramos,Us Open
0,0,0,,0,0,0,,Albert Ramos,Stefanos Tsitsipas,Albert Ramos,Us Open
0,0,0,,0,0,0,,Maxime Cressy,Maxime Cressy,Jozef Kovalik,Us Open
0,0,0,,0,0,0,,Jozef Kovalik,Maxime Cressy,Jozef Kovalik,Us Open
0,0,0,,0,0,0,,Juan Ignacio Londero,Juan Ignacio Londero,Evgeny Donskoy,Us Open
0,0,0,,0,0,0,,Evgeny Donskoy,Juan Ignacio Londero,Evgeny Donskoy,Us Open
1,1,2,50.0,1,1,2,50.0,Borna Coric,Borna Coric,Pablo Andujar,Us Open
0,0,0,,0,0,0,,Pablo Andujar,Borna Coric,Pablo Andujar,Us Open
0,0,0,,0,0,0,,Egor Gerasimov,Egor Gerasimov,Dusan Lajovic,Us Open
0,1,1,0.0,0,1,1,0.0,Dusan Lajovic,Egor Gerasimov,Dusan Lajovic,Us Open
0,0,0,,0,0,0,,Jordan Thompson,Jordan Thompson,Stefano Travaglia,Us Open
0,0,0,,0,0,0,,Stefano Travaglia,Jordan Thompson,Stefano Travaglia,Us Open
0,0,0,,0,0,0,,Mikhail Kukushkin,Mikhail Kukushkin,Attila Balazs,Us Open
0,0,0,,0,0,0,,Attila Balazs,Mikhail Kukushkin,Attila Balazs,Us Open
0,1,1,0.0,0,1,1,0.0,Christian Garin,Christian Garin,Ulises Blanch,Us Open
0,0,0,,0,0,0,,Ulises Blanch,Christian Garin,Ulises Blanch,Us Open
0,1,1,0.0,0,1,1,0.0,Cameron Norrie,Cameron Norrie,Diego Schwartzman,Us Open
1,1,2,50.0,1,1,2,50.0,Diego Schwartzman,Cameron Norrie,Diego Schwartzman,Us Open
0,0,0,,0,0,0,,Federico Coria,Federico Coria,Jason Jung,Us Open
0,0,0,,0,0,0,,Jason Jung,Federico Coria,Jason Jung,Us Open
0,0,0,,0,0,0,,Alejandro Davidovich Fokina,Alejandro Davidovich Fokina,Dennis Novak,Us Open
0,0,0,,0,0,0,,Dennis Novak,Alejandro Davidovich Fokina,Dennis Novak,Us Open
0,1,1,0.0,0,1,1,0.0,Hubert Hurkacz,Hubert Hurkacz,Peter Gojowczyk,Us Open
0,0,0,,0,0,0,,Peter Gojowczyk,Hubert Hurkacz,Peter Gojowczyk,Us Open
0,1,1,0.0,0,1,1,0.0,Adrian Mannarino,Adrian Mannarino,Lorenzo Sonego,Us Open
0,1,1,0.0,0,1,1,0.0,Lorenzo Sonego,Adrian Mannarino,Lorenzo Sonego,Us Open
0,0,0,,0,0,0,,Jack Sock,Jack Sock,Pablo Cuevas,Us Open
0,0,0,,0,0,0,,Pablo Cuevas,Jack Sock,Pablo Cuevas,Us Open
0,0,0,,0,0,0,,Brandon Nakashima,Brandon Nakashima,Paolo Lorenzi,Us Open
0,0,0,,0,0,0,,Paolo Lorenzi,Brandon Nakashima,Paolo Lorenzi,Us Open
0,1,1,0.0,0,1,1,0.0,Alexander Zverev,Alexander Zverev,Kevin Anderson,Us Open
1,1,2,50.0,1,1,2,50.0,Kevin Anderson,Alexander Zverev,Kevin Anderson,Us Open
1,1,2,50.0,1,1,2,50.0,Matteo Berrettini,Matteo Berrettini,Go Soeda,Us Open
0,0,0,,0,0,0,,Go Soeda,Matteo Berrettini,Go Soeda,Us Open
0,1,1,0.0,0,1,1,0.0,Ugo Humbert,Ugo Humbert,Yuichi Sugita,Us Open
0,0,0,,0,0,0,,Yuichi Sugita,Ugo Humbert,Yuichi Sugita,Us Open
1,1,2,50.0,1,1,2,50.0,Emil Ruusuvuori,Emil Ruusuvuori,Aljaz Bedene,Us Open
2,1,3,66.66666666666667,2,1,3,66.66666666666667,Aljaz Bedene,Emil Ruusuvuori,Aljaz Bedene,Us Open
0,1,1,0.0,0,1,1,0.0,Casper Ruud,Casper Ruud,Mackenzie McDonald,Us Open
0,1,1,0.0,0,1,1,0.0,Mackenzie McDonald,Casper Ruud,Mackenzie McDonald,Us Open
0,0,0,,0,0,0,,Ernesto Escobedo,Ernesto Escobedo,Kamil Majchrzak,Us Open
0,0,0,,0,0,0,,Kamil Majchrzak,Ernesto Escobedo,Kamil Majchrzak,Us Open
0,1,1,0.0,0,1,1,0.0,Salvatore Caruso,Salvatore Caruso,James Duckworth,Us Open
0,0,0,,0,0,0,,James Duckworth,Salvatore Caruso,James Duckworth,Us Open
0,0,0,,0,0,0,,Gregoire Barrere,Gregoire Barrere,Taro Daniel,Us Open
0,0,0,,0,0,0,,Taro Daniel,Gregoire Barrere,Taro Daniel,Us Open
0,1,1,0.0,0,1,1,0.0,Andrey Rublev,Andrey Rublev,Jeremy Chardy,Us Open
0,0,0,,0,0,0,,Jeremy Chardy,Andrey Rublev,Jeremy Chardy,Us Open
1,1,2,50.0,1,1,2,50.0,Grigor Dimitrov,Grigor Dimitrov,Tommy Paul,Us Open
0,1,1,0.0,0,1,1,0.0,Tommy Paul,Grigor Dimitrov,Tommy Paul,Us Open
2,1,3,66.66666666666667,2,1,3,66.66666666666667,Marton Fucsovics,Marton Fucsovics,Hugo Dellien,Us Open
0,0,0,,0,0,0,,Hugo Dellien,Marton Fucsovics,Hugo Dellien,Us Open
0,1,1,0.0,0,1,1,0.0,Frances Tiafoe,Frances Tiafoe,Andreas Seppi,Us Open
0,0,0,,0,0,0,,Andreas Seppi,Frances Tiafoe,Andreas Seppi,Us Open
1,1,2,50.0,1,1,2,50.0,John Millman,John Millman,Nikoloz Basilashvili,Us Open
0,1,1,0.0,0,1,1,0.0,Nikoloz Basilashvili,John Millman,Nikoloz Basilashvili,Us Open
0,1,1,0.0,0,1,1,0.0,J.J. Wolf,J.J. Wolf,Guido Pella,Us Open
0,0,0,,0,0,0,,Guido Pella,J.J. Wolf,Guido Pella,Us Open
0,0,0,,0,0,0,,Roberto Carballes Baena,Roberto Carballes Baena,Feliciano Lopez,Us Open
0,0,0,,0,0,0,,Feliciano Lopez,Roberto Carballes Baena,Feliciano Lopez,Us Open
0,0,0,,0,0,0,,Christopher O'Connell,Christopher O'Connell,Laslo Djere,Us Open
0,0,0,,0,0,0,,Laslo Djere,Christopher O'Connell,Laslo Djere,Us Open
2,1,3,66.66666666666667,2,1,3,66.66666666666667,Daniil Medvedev,Daniil Medvedev,Federico Delbonis,Us Open
0,0,0,,0,0,0,,Federico Delbonis,Daniil Medvedev,Federico Delbonis,Us Open
3,1,4,75.0,3,1,4,75.0,Roberto Bautista Agut,Roberto Bautista Agut,Tennys Sandgren,Us Open
2,1,3,66.66666666666667,2,1,3,66.66666666666667,Tennys Sandgren,Roberto Bautista Agut,Tennys Sandgren,Us Open
0,0,0,,0,0,0,,Miomir Kecmanovic,Miomir Kecmanovic,Gianluca Mager,Us Open
0,0,0,,0,0,0,,Gianluca Mager,Miomir Kecmanovic,Gianluca Mager,Us Open
0,0,0,,0,0,0,,Vasek Pospisil,Vasek Pospisil,Philipp Kohlschreiber,Us Open
0,0,0,,0,0,0,,Philipp Kohlschreiber,Vasek Pospisil,Philipp Kohlschreiber,Us Open
5,1,6,83.33333333333333,5,1,6,83.33333333333333,Milos Raonic,Milos Raonic,Leonardo Mayer,Us Open
0,0,0,,0,0,0,,Leonardo Mayer,Milos Raonic,Leonardo Mayer,Us Open
0,1,1,0.0,0,1,1,0.0,Alex De Minaur,Alex De Minaur,Andrej Martin,Us Open
0,0,0,,0,0,0,,Andrej Martin,Alex De Minaur,Andrej Martin,Us Open
1,1,2,50.0,1,1,2,50.0,Richard Gasquet,Richard Gasquet,Ivo Karlovic,Us Open
0,0,0,,0,0,0,,Ivo Karlovic,Richard Gasquet,Ivo Karlovic,Us Open
0,0,0,,0,0,0,,Andrey Kuznetsov,Andrey Kuznetsov,Sam Querrey,Us Open
0,1,1,0.0,0,1,1,0.0,Sam Querrey,Andrey Kuznetsov,Sam Querrey,Us Open
2,1,3,66.66666666666667,2,1,3,66.66666666666667,Karen Khachanov,Karen Khachanov,Jannik Sinner,Us Open
0,0,0,,0,0,0,,Jannik Sinner,Karen Khachanov,Jannik Sinner,Us Open
1,1,2,50.0,1,1,2,50.0,Felix Auger Aliassime,Felix Auger Aliassime,Thiago Monteiro,Us Open
0,0,0,,0,0,0,,Thiago Monteiro,Felix Auger Aliassime,Thiago Monteiro,Us Open
2,1,3,66.66666666666667,2,1,3,66.66666666666667,Andy Murray,Andy Murray,Yoshihito Nishioka,Us Open
0,0,0,,0,0,0,,Yoshihito Nishioka,Andy Murray,Yoshihito Nishioka,Us Open
0,0,0,,0,0,0,,Corentin Moutet,Corentin Moutet,Jiri Vesely,Us Open
0,0,0,,0,0,0,,Jiri Vesely,Corentin Moutet,Jiri Vesely,Us Open
1,1,2,50.0,1,1,2,50.0,Daniel Evans,Daniel Evans,Thiago Seyboth Wild,Us Open
0,0,0,,0,0,0,,Thiago Seyboth Wild,Daniel Evans,Thiago Seyboth Wild,Us Open
0,1,1,0.0,0,1,1,0.0,Marin Cilic,Marin Cilic,Denis Kudla,Us Open
0,0,0,,0,0,0,,Denis Kudla,Marin Cilic,Denis Kudla,Us Open
0,1,1,0.0,0,1,1,0.0,Norbert Gombos,Norbert Gombos,Radu Albot,Us Open
0,0,0,,0,0,0,,Radu Albot,Norbert Gombos,Radu Albot,Us Open
0,0,0,,0,0,0,,Sumit Nagal,Sumit Nagal,Bradley Klahn,Us Open
0,0,0,,0,0,0,,Bradley Klahn,Sumit Nagal,Bradley Klahn,Us Open
0,1,1,0.0,0,1,1,0.0,Dominic Thiem,Dominic Thiem,Jaume Munar,Us Open
0,0,0,,0,0,0,,Jaume Munar,Dominic Thiem,Jaume Munar,Us Open
6,0,6,100.0,6,0,6,100.0,Novak Djokovic,Novak Djokovic,Kyle Edmund,Us Open
1,1,2,50.0,1,1,2,50.0,Kyle Edmund,Novak Djokovic,Kyle Edmund,Us Open
4,1,5,80.0,4,1,5,80.0,Jan Lennard Struff,Jan Lennard Struff,Michael Mmoh,Us Open
1,0,1,100.0,1,0,1,100.0,Michael Mmoh,Jan Lennard Struff,Michael Mmoh,Us Open
2,1,3,66.66666666666667,2,1,3,66.66666666666667,Pablo Carreno Busta,Pablo Carreno Busta,Mitchell Krueger,Us Open
1,0,1,100.0,1,0,1,100.0,Mitchell Krueger,Pablo Carreno Busta,Mitchell Krueger,Us Open
2,1,3,66.66666666666667,2,1,3,66.66666666666667,Ricardas Berankis,Ricardas Berankis,Steve Johnson,Us Open
1,0,1,100.0,1,0,1,100.0,Steve Johnson,Ricardas Berankis,Steve Johnson,Us Open
2,1,3,66.66666666666667,2,1,3,66.66666666666667,Denis Shapovalov,Denis Shapovalov,Soon Woo Kwon,Us Open
1,0,1,100.0,1,0,1,100.0,Soon Woo Kwon,Denis Shapovalov,Soon Woo Kwon,Us Open
2,1,3,66.66666666666667,2,1,3,66.66666666666667,Taylor Fritz,Taylor Fritz,Gilles Simon,Us Open
1,0,1,100.0,1,0,1,100.0,Gilles Simon,Taylor Fritz,Gilles Simon,Us Open
4,1,5,80.0,4,1,5,80.0,Filip Krajinovic,Filip Krajinovic,Marcos Giron,Us Open
2,1,3,66.66666666666667,2,1,3,66.66666666666667,Marcos Giron,Filip Krajinovic,Marcos Giron,Us Open
2,1,3,66.66666666666667,2,1,3,66.66666666666667,David Goffin,David Goffin,Lloyd Harris,Us Open
1,1,2,50.0,1,1,2,50.0,Lloyd Harris,David Goffin,Lloyd Harris,Us Open
4,1,5,80.0,4,1,5,80.0,Stefanos Tsitsipas,Stefanos Tsitsipas,Maxime Cressy,Us Open
1,0,1,100.0,1,0,1,100.0,Maxime Cressy,Stefanos Tsitsipas,Maxime Cressy,Us Open
2,1,3,66.66666666666667,2,1,3,66.66666666666667,Borna Coric,Borna Coric,Juan Ignacio Londero,Us Open
1,0,1,100.0,1,0,1,100.0,Juan Ignacio Londero,Borna Coric,Juan Ignacio Londero,Us Open
1,0,1,100.0,1,0,1,100.0,Jordan Thompson,Jordan Thompson,Egor Gerasimov,Us Open
1,0,1,100.0,1,0,1,100.0,Egor Gerasimov,Jordan Thompson,Egor Gerasimov,Us Open
1,0,1,100.0,1,0,1,100.0,Mikhail Kukushkin,Mikhail Kukushkin,Christian Garin,Us Open
1,1,2,50.0,1,1,2,50.0,Christian Garin,Mikhail Kukushkin,Christian Garin,Us Open
1,1,2,50.0,1,1,2,50.0,Cameron Norrie,Cameron Norrie,Federico Coria,Us Open
1,0,1,100.0,1,0,1,100.0,Federico Coria,Cameron Norrie,Federico Coria,Us Open
1,0,1,100.0,1,0,1,100.0,Alejandro Davidovich Fokina,Alejandro Davidovich Fokina,Hubert Hurkacz,Us Open
1,1,2,50.0,1,1,2,50.0,Hubert Hurkacz,Alejandro Davidovich Fokina,Hubert Hurkacz,Us Open
1,1,2,50.0,1,1,2,50.0,Adrian Mannarino,Adrian Mannarino,Jack Sock,Us Open
1,0,1,100.0,1,0,1,100.0,Jack Sock,Adrian Mannarino,Jack Sock,Us Open
1,1,2,50.0,1,1,2,50.0,Alexander Zverev,Alexander Zverev,Brandon Nakashima,Us Open
1,0,1,100.0,1,0,1,100.0,Brandon Nakashima,Alexander Zverev,Brandon Nakashima,Us Open
2,1,3,66.66666666666667,2,1,3,66.66666666666667,Matteo Berrettini,Matteo Berrettini,Ugo Humbert,Us Open
1,1,2,50.0,1,1,2,50.0,Ugo Humbert,Matteo Berrettini,Ugo Humbert,Us Open
1,1,2,50.0,1,1,2,50.0,Casper Ruud,Casper Ruud,Emil Ruusuvuori,Us Open
2,1,3,66.66666666666667,2,1,3,66.66666666666667,Emil Ruusuvuori,Casper Ruud,Emil Ruusuvuori,Us Open
1,1,2,50.0,1,1,2,50.0,Salvatore Caruso,Salvatore Caruso,Ernesto Escobedo,Us Open
1,0,1,100.0,1,0,1,100.0,Ernesto Escobedo,Salvatore Caruso,Ernesto Escobedo,Us Open
1,1,2,50.0,1,1,2,50.0,Andrey Rublev,Andrey Rublev,Gregoire Barrere,Us Open
1,0,1,100.0,1,0,1,100.0,Gregoire Barrere,Andrey Rublev,Gregoire Barrere,Us Open
3,1,4,75.0,3,1,4,75.0,Marton Fucsovics,Marton Fucsovics,Grigor Dimitrov,Us Open
2,1,3,66.66666666666667,2,1,3,66.66666666666667,Grigor Dimitrov,Marton Fucsovics,Grigor Dimitrov,Us Open
1,1,2,50.0,1,1,2,50.0,Frances Tiafoe,Frances Tiafoe,John Millman,Us Open
2,1,3,66.66666666666667,2,1,3,66.66666666666667,John Millman,Frances Tiafoe,John Millman,Us Open
1,1,2,50.0,1,1,2,50.0,J.J. Wolf,J.J. Wolf,Roberto Carballes Baena,Us Open
1,0,1,100.0,1,0,1,100.0,Roberto Carballes Baena,J.J. Wolf,Roberto Carballes Baena,Us Open
3,1,4,75.0,3,1,4,75.0,Daniil Medvedev,Daniil Medvedev,Christopher O'Connell,Us Open
1,0,1,100.0,1,0,1,100.0,Christopher O'Connell,Daniil Medvedev,Christopher O'Connell,Us Open
4,1,5,80.0,4,1,5,80.0,Roberto Bautista Agut,Roberto Bautista Agut,Miomir Kecmanovic,Us Open
1,0,1,100.0,1,0,1,100.0,Miomir Kecmanovic,Roberto Bautista Agut,Miomir Kecmanovic,Us Open
1,0,1,100.0,1,0,1,100.0,Vasek Pospisil,Vasek Pospisil,Milos Raonic,Us Open
6,1,7,85.71428571428571,6,1,7,85.71428571428571,Milos Raonic,Vasek Pospisil,Milos Raonic,Us Open
1,1,2,50.0,1,1,2,50.0,Alex De Minaur,Alex De Minaur,Richard Gasquet,Us Open
2,1,3,66.66666666666667,2,1,3,66.66666666666667,Richard Gasquet,Alex De Minaur,Richard Gasquet,Us Open
3,1,4,75.0,3,1,4,75.0,Karen Khachanov,Karen Khachanov,Andrey Kuznetsov,Us Open
1,0,1,100.0,1,0,1,100.0,Andrey Kuznetsov,Karen Khachanov,Andrey Kuznetsov,Us Open
2,1,3,66.66666666666667,2,1,3,66.66666666666667,Felix Auger Aliassime,Felix Auger Aliassime,Andy Murray,Us Open
3,1,4,75.0,3,1,4,75.0,Andy Murray,Felix Auger Aliassime,Andy Murray,Us Open
1,0,1,100.0,1,0,1,100.0,Corentin Moutet,Corentin Moutet,Daniel Evans,Us Open
2,1,3,66.66666666666667,2,1,3,66.66666666666667,Daniel Evans,Corentin Moutet,Daniel Evans,Us Open
1,1,2,50.0,1,1,2,50.0,Marin Cilic,Marin Cilic,Norbert Gombos,Us Open
1,1,2,50.0,1,1,2,50.0,Norbert Gombos,Marin Cilic,Norbert Gombos,Us Open
1,1,2,50.0,1,1,2,50.0,Dominic Thiem,Dominic Thiem,Sumit Nagal,Us Open
1,0,1,100.0,1,0,1,100.0,Sumit Nagal,Dominic Thiem,Sumit Nagal,Us Open
7,0,7,100.0,7,0,7,100.0,Novak Djokovic,Novak Djokovic,Jan Lennard Struff,Us Open
5,1,6,83.33333333333333,5,1,6,83.33333333333333,Jan Lennard Struff,Novak Djokovic,Jan Lennard Struff,Us Open
3,1,4,75.0,3,1,4,75.0,Pablo Carreno Busta,Pablo Carreno Busta,Ricardas Berankis,Us Open
3,1,4,75.0,3,1,4,75.0,Ricardas Berankis,Pablo Carreno Busta,Ricardas Berankis,Us Open
3,1,4,75.0,3,1,4,75.0,Denis Shapovalov,Denis Shapovalov,Taylor Fritz,Us Open
3,1,4,75.0,3,1,4,75.0,Taylor Fritz,Denis Shapovalov,Taylor Fritz,Us Open
3,1,4,75.0,3,1,4,75.0,David Goffin,David Goffin,Filip Krajinovic,Us Open
5,1,6,83.33333333333333,5,1,6,83.33333333333333,Filip Krajinovic,David Goffin,Filip Krajinovic,Us Open
3,1,4,75.0,3,1,4,75.0,Borna Coric,Borna Coric,Stefanos Tsitsipas,Us Open
5,1,6,83.33333333333333,5,1,6,83.33333333333333,Stefanos Tsitsipas,Borna Coric,Stefanos Tsitsipas,Us Open
2,0,2,100.0,2,0,2,100.0,Jordan Thompson,Jordan Thompson,Mikhail Kukushkin,Us Open
2,0,2,100.0,2,0,2,100.0,Mikhail Kukushkin,Jordan Thompson,Mikhail Kukushkin,Us Open
2,0,2,100.0,2,0,2,100.0,Alejandro Davidovich Fokina,Alejandro Davidovich Fokina,Cameron Norrie,Us Open
2,1,3,66.66666666666667,2,1,3,66.66666666666667,Cameron Norrie,Alejandro Davidovich Fokina,Cameron Norrie,Us Open
2,1,3,66.66666666666667,2,1,3,66.66666666666667,Alexander Zverev,Alexander Zverev,Adrian Mannarino,Us Open
2,1,3,66.66666666666667,2,1,3,66.66666666666667,Adrian Mannarino,Alexander Zverev,Adrian Mannarino,Us Open
3,1,4,75.0,3,1,4,75.0,Matteo Berrettini,Matteo Berrettini,Casper Ruud,Us Open
2,1,3,66.66666666666667,2,1,3,66.66666666666667,Casper Ruud,Matteo Berrettini,Casper Ruud,Us Open
2,1,3,66.66666666666667,2,1,3,66.66666666666667,Andrey Rublev,Andrey Rublev,Salvatore Caruso,Us Open
2,1,3,66.66666666666667,2,1,3,66.66666666666667,Salvatore Caruso,Andrey Rublev,Salvatore Caruso,Us Open
2,1,3,66.66666666666667,2,1,3,66.66666666666667,Frances Tiafoe,Frances Tiafoe,Marton Fucsovics,Us Open
4,1,5,80.0,4,1,5,80.0,Marton Fucsovics,Frances Tiafoe,Marton Fucsovics,Us Open
4,1,5,80.0,4,1,5,80.0,Daniil Medvedev,Daniil Medvedev,J.J. Wolf,Us Open
2,1,3,66.66666666666667,2,1,3,66.66666666666667,J.J. Wolf,Daniil Medvedev,J.J. Wolf,Us Open
2,0,2,100.0,2,0,2,100.0,Vasek Pospisil,Vasek Pospisil,Roberto Bautista Agut,Us Open
5,1,6,83.33333333333333,5,1,6,83.33333333333333,Roberto Bautista Agut,Vasek Pospisil,Roberto Bautista Agut,Us Open
2,1,3,66.66666666666667,2,1,3,66.66666666666667,Alex De Minaur,Alex De Minaur,Karen Khachanov,Us Open
4,1,5,80.0,4,1,5,80.0,Karen Khachanov,Alex De Minaur,Karen Khachanov,Us Open
3,1,4,75.0,3,1,4,75.0,Felix Auger Aliassime,Felix Auger Aliassime,Corentin Moutet,Us Open
2,0,2,100.0,2,0,2,100.0,Corentin Moutet,Felix Auger Aliassime,Corentin Moutet,Us Open
2,1,3,66.66666666666667,2,1,3,66.66666666666667,Dominic Thiem,Dominic Thiem,Marin Cilic,Us Open
2,1,3,66.66666666666667,2,1,3,66.66666666666667,Marin Cilic,Dominic Thiem,Marin Cilic,Us Open
4,1,5,80.0,4,1,5,80.0,Pablo Carreno Busta,Pablo Carreno Busta,Novak Djokovic,Us Open
8,0,8,100.0,8,0,8,100.0,Novak Djokovic,Pablo Carreno Busta,Novak Djokovic,Us Open
4,1,5,80.0,4,1,5,80.0,Denis Shapovalov,Denis Shapovalov,David Goffin,Us Open
4,1,5,80.0,4,1,5,80.0,David Goffin,Denis Shapovalov,David Goffin,Us Open
4,1,5,80.0,4,1,5,80.0,Borna Coric,Borna Coric,Jordan Thompson,Us Open
3,0,3,100.0,3,0,3,100.0,Jordan Thompson,Borna Coric,Jordan Thompson,Us Open
3,1,4,75.0,3,1,4,75.0,Alexander Zverev,Alexander Zverev,Alejandro Davidovich Fokina,Us Open
3,0,3,100.0,3,0,3,100.0,Alejandro Davidovich Fokina,Alexander Zverev,Alejandro Davidovich Fokina,Us Open
3,1,4,75.0,3,1,4,75.0,Andrey Rublev,Andrey Rublev,Matteo Berrettini,Us Open
4,1,5,80.0,4,1,5,80.0,Matteo Berrettini,Andrey Rublev,Matteo Berrettini,Us Open
5,1,6,83.33333333333333,5,1,6,83.33333333333333,Daniil Medvedev,Daniil Medvedev,Frances Tiafoe,Us Open
3,1,4,75.0,3,1,4,75.0,Frances Tiafoe,Daniil Medvedev,Frances Tiafoe,Us Open
3,1,4,75.0,3,1,4,75.0,Alex De Minaur,Alex De Minaur,Vasek Pospisil,Us Open
3,0,3,100.0,3,0,3,100.0,Vasek Pospisil,Alex De Minaur,Vasek Pospisil,Us Open
3,1,4,75.0,3,1,4,75.0,Dominic Thiem,Dominic Thiem,Felix Auger Aliassime,Us Open
4,1,5,80.0,4,1,5,80.0,Felix Auger Aliassime,Dominic Thiem,Felix Auger Aliassime,Us Open
5,1,6,83.33333333333333,5,1,6,83.33333333333333,Pablo Carreno Busta,Pablo Carreno Busta,Denis Shapovalov,Us Open
5,1,6,83.33333333333333,5,1,6,83.33333333333333,Denis Shapovalov,Pablo Carreno Busta,Denis Shapovalov,Us Open
4,1,5,80.0,4,1,5,80.0,Alexander Zverev,Alexander Zverev,Borna Coric,Us Open
5,1,6,83.33333333333333,5,1,6,83.33333333333333,Borna Coric,Alexander Zverev,Borna Coric,Us Open
6,1,7,85.71428571428571,6,1,7,85.71428571428571,Daniil Medvedev,Daniil Medvedev,Andrey Rublev,Us Open
4,1,5,80.0,4,1,5,80.0,Andrey Rublev,Daniil Medvedev,Andrey Rublev,Us Open
4,1,5,80.0,4,1,5,80.0,Dominic Thiem,Dominic Thiem,Alex De Minaur,Us Open
4,1,5,80.0,4,1,5,80.0,Alex De Minaur,Dominic Thiem,Alex De Minaur,Us Open
5,1,6,83.33333333333333,5,1,6,83.33333333333333,Alexander Zverev,Alexander Zverev,Pablo Carreno Busta,Us Open
6,1,7,85.71428571428571,6,1,7,85.71428571428571,Pablo Carreno Busta,Alexander Zverev,Pablo Carreno Busta,Us Open
5,1,6,83.33333333333333,5,1,6,83.33333333333333,Dominic Thiem,Dominic Thiem,Daniil Medvedev,Us Open
7,1,8,87.5,7,1,8,87.5,Daniil Medvedev,Dominic Thiem,Daniil Medvedev,Us Open
6,1,7,85.71428571428571,6,1,7,85.71428571428571,Dominic Thiem,Dominic Thiem,Alexander Zverev,Us Open
6,1,7,85.71428571428571,6,1,7,85.71428571428571,Alexander Zverev,Dominic Thiem,Alexander Zverev,Us Open
0,0,0,,0,0,0,,Sebastian Ofner,Sebastian Ofner,Radu Albot,Kitzbuhel
0,1,1,0.0,0,0,0,,Radu Albot,Sebastian Ofner,Radu Albot,Kitzbuhel
0,1,1,0.0,0,0,0,,Jannik Sinner,Jannik Sinner,Philipp Kohlschreiber,Kitzbuhel
0,1,1,0.0,0,0,0,,Philipp Kohlschreiber,Jannik Sinner,Philipp Kohlschreiber,Kitzbuhel
0,1,1,0.0,0,0,0,,Laslo Djere,Laslo Djere,Albert Ramos,Kitzbuhel
0,1,1,0.0,0,0,0,,Albert Ramos,Laslo Djere,Albert Ramos,Kitzbuhel
0,0,0,,0,0,0,,Yannick Hanfmann,Yannick Hanfmann,Alexander Bublik,Kitzbuhel
0,2,2,0.0,0,0,0,,Alexander Bublik,Yannick Hanfmann,Alexander Bublik,Kitzbuhel
0,0,0,,0,0,0,,Maximilian Marterer,Maximilian Marterer,Dennis Novak,Kitzbuhel
0,1,1,0.0,0,0,0,,Dennis Novak,Maximilian Marterer,Dennis Novak,Kitzbuhel
1,2,3,33.333333333333336,0,0,0,,Hubert Hurkacz,Hubert Hurkacz,Joao Sousa,Kitzbuhel
0,1,1,0.0,0,0,0,,Joao Sousa,Hubert Hurkacz,Joao Sousa,Kitzbuhel
1,1,2,50.0,0,0,0,,Miomir Kecmanovic,Miomir Kecmanovic,Kei Nishikori,Kitzbuhel
0,0,0,,0,0,0,,Kei Nishikori,Miomir Kecmanovic,Kei Nishikori,Kitzbuhel
3,1,4,75.0,0,0,0,,Jordan Thompson,Jordan Thompson,John Millman,Kitzbuhel
2,2,4,50.0,0,0,0,,John Millman,Jordan Thompson,John Millman,Kitzbuhel
0,1,1,0.0,0,0,0,,Federico Delbonis,Federico Delbonis,Juan Ignacio Londero,Kitzbuhel
1,1,2,50.0,0,0,0,,Juan Ignacio Londero,Federico Delbonis,Juan Ignacio Londero,Kitzbuhel
0,1,1,0.0,0,0,0,,Guido Pella,Guido Pella,Yoshihito Nishioka,Kitzbuhel
0,1,1,0.0,0,0,0,,Yoshihito Nishioka,Guido Pella,Yoshihito Nishioka,Kitzbuhel
0,1,1,0.0,0,0,0,,Feliciano Lopez,Feliciano Lopez,Pierre Hugues Herbert,Kitzbuhel
0,0,0,,0,0,0,,Pierre Hugues Herbert,Feliciano Lopez,Pierre Hugues Herbert,Kitzbuhel
0,0,0,,0,0,0,,Marc Andrea Huesler,Marc Andrea Huesler,Emil Ruusuvuori,Kitzbuhel
2,2,4,50.0,0,0,0,,Emil Ruusuvuori,Marc Andrea Huesler,Emil Ruusuvuori,Kitzbuhel
1,2,3,33.333333333333336,0,0,0,,Diego Schwartzman,Diego Schwartzman,Sebastian Ofner,Kitzbuhel
1,0,1,100.0,1,0,1,100.0,Sebastian Ofner,Diego Schwartzman,Sebastian Ofner,Kitzbuhel
1,1,2,50.0,1,0,1,100.0,Laslo Djere,Laslo Djere,Jannik Sinner,Kitzbuhel
1,1,2,50.0,1,0,1,100.0,Jannik Sinner,Laslo Djere,Jannik Sinner,Kitzbuhel
1,0,1,100.0,1,0,1,100.0,Yannick Hanfmann,Yannick Hanfmann,Dusan Lajovic,Kitzbuhel
0,2,2,0.0,0,0,0,,Dusan Lajovic,Yannick Hanfmann,Dusan Lajovic,Kitzbuhel
1,0,1,100.0,1,0,1,100.0,Maximilian Marterer,Maximilian Marterer,Hubert Hurkacz,Kitzbuhel
2,2,4,50.0,1,0,1,100.0,Hubert Hurkacz,Maximilian Marterer,Hubert Hurkacz,Kitzbuhel
2,1,3,66.66666666666667,1,0,1,100.0,Miomir Kecmanovic,Miomir Kecmanovic,Jordan Thompson,Kitzbuhel
4,1,5,80.0,1,0,1,100.0,Jordan Thompson,Miomir Kecmanovic,Jordan Thompson,Kitzbuhel
1,1,2,50.0,1,0,1,100.0,Federico Delbonis,Federico Delbonis,Nikoloz Basilashvili,Kitzbuhel
0,2,2,0.0,0,0,0,,Nikoloz Basilashvili,Federico Delbonis,Nikoloz Basilashvili,Kitzbuhel
1,1,2,50.0,1,0,1,100.0,Feliciano Lopez,Feliciano Lopez,Guido Pella,Kitzbuhel
1,1,2,50.0,1,0,1,100.0,Guido Pella,Feliciano Lopez,Guido Pella,Kitzbuhel
1,0,1,100.0,1,0,1,100.0,Marc Andrea Huesler,Marc Andrea Huesler,Fabio Fognini,Kitzbuhel
0,0,0,,0,0,0,,Fabio Fognini,Marc Andrea Huesler,Fabio Fognini,Kitzbuhel
2,1,3,66.66666666666667,2,0,2,100.0,Laslo Djere,Laslo Djere,Diego Schwartzman,Kitzbuhel
2,2,4,50.0,1,0,1,100.0,Diego Schwartzman,Laslo Djere,Diego Schwartzman,Kitzbuhel
2,0,2,100.0,2,0,2,100.0,Yannick Hanfmann,Yannick Hanfmann,Maximilian Marterer,Kitzbuhel
2,0,2,100.0,2,0,2,100.0,Maximilian Marterer,Yannick Hanfmann,Maximilian Marterer,Kitzbuhel
3,1,4,75.0,2,0,2,100.0,Miomir Kecmanovic,Miomir Kecmanovic,Federico Delbonis,Kitzbuhel
2,1,3,66.66666666666667,2,0,2,100.0,Federico Delbonis,Miomir Kecmanovic,Federico Delbonis,Kitzbuhel
2,0,2,100.0,2,0,2,100.0,Marc Andrea Huesler,Marc Andrea Huesler,Feliciano Lopez,Kitzbuhel
2,1,3,66.66666666666667,2,0,2,100.0,Feliciano Lopez,Marc Andrea Huesler,Feliciano Lopez,Kitzbuhel
3,0,3,100.0,3,0,3,100.0,Yannick Hanfmann,Yannick Hanfmann,Laslo Djere,Kitzbuhel
3,1,4,75.0,3,0,3,100.0,Laslo Djere,Yannick Hanfmann,Laslo Djere,Kitzbuhel
4,1,5,80.0,3,0,3,100.0,Miomir Kecmanovic,Miomir Kecmanovic,Marc Andrea Huesler,Kitzbuhel
3,0,3,100.0,3,0,3,100.0,Marc Andrea Huesler,Miomir Kecmanovic,Marc Andrea Huesler,Kitzbuhel
5,1,6,83.33333333333333,4,0,4,100.0,Miomir Kecmanovic,Miomir Kecmanovic,Yannick Hanfmann,Kitzbuhel
4,0,4,100.0,4,0,4,100.0,Yannick Hanfmann,Miomir Kecmanovic,Yannick Hanfmann,Kitzbuhel
0,3,3,0.0,0,1,1,0.0,Dusan Lajovic,Dusan Lajovic,Alejandro Davidovich Fokina,Rome Masters
3,1,4,75.0,0,0,0,,Alejandro Davidovich Fokina,Dusan Lajovic,Alejandro Davidovich Fokina,Rome Masters
6,2,8,75.0,0,0,0,,Milos Raonic,Milos Raonic,Adrian Mannarino,Rome Masters
2,2,4,50.0,0,0,0,,Adrian Mannarino,Milos Raonic,Adrian Mannarino,Rome Masters
4,2,6,66.66666666666667,0,0,0,,Andrey Rublev,Andrey Rublev,Facundo Bagnis,Rome Masters
0,0,0,,0,0,0,,Facundo Bagnis,Andrey Rublev,Facundo Bagnis,Rome Masters
2,3,5,40.0,1,1,2,50.0,Hubert Hurkacz,Hubert Hurkacz,Daniel Evans,Rome Masters
2,2,4,50.0,0,0,0,,Daniel Evans,Hubert Hurkacz,Daniel Evans,Rome Masters
2,3,5,40.0,0,1,1,0.0,John Millman,John Millman,Joao Sousa,Rome Masters
0,2,2,0.0,0,1,1,0.0,Joao Sousa,John Millman,Joao Sousa,Rome Masters
1,2,3,33.333333333333336,1,1,2,50.0,Jannik Sinner,Jannik Sinner,Benoit Paire,Rome Masters
0,1,1,0.0,0,0,0,,Benoit Paire,Jannik Sinner,Benoit Paire,Rome Masters
0,2,2,0.0,0,1,1,0.0,Yoshihito Nishioka,Yoshihito Nishioka,Miomir Kecmanovic,Rome Masters
6,1,7,85.71428571428571,5,0,5,100.0,Miomir Kecmanovic,Yoshihito Nishioka,Miomir Kecmanovic,Rome Masters
2,2,4,50.0,0,0,0,,Grigor Dimitrov,Grigor Dimitrov,Gianluca Mager,Rome Masters
0,1,1,0.0,0,0,0,,Gianluca Mager,Grigor Dimitrov,Gianluca Mager,Rome Masters
5,2,7,71.42857142857143,0,0,0,,Denis Shapovalov,Denis Shapovalov,Guido Pella,Rome Masters
1,2,3,33.333333333333336,1,1,2,50.0,Guido Pella,Denis Shapovalov,Guido Pella,Rome Masters
0,1,1,0.0,0,0,0,,Pedro Martinez,Pedro Martinez,Sam Querrey,Rome Masters
0,2,2,0.0,0,0,0,,Sam Querrey,Pedro Martinez,Sam Querrey,Rome Masters
1,2,3,33.333333333333336,0,0,0,,Ugo Humbert,Ugo Humbert,Kevin Anderson,Rome Masters
1,2,3,33.333333333333336,0,0,0,,Kevin Anderson,Ugo Humbert,Kevin Anderson,Rome Masters
2,2,4,50.0,0,0,0,,Marin Cilic,Marin Cilic,Alexander Bublik,Rome Masters
0,3,3,0.0,0,1,1,0.0,Alexander Bublik,Marin Cilic,Alexander Bublik,Rome Masters
0,2,2,0.0,0,0,0,,Lorenzo Sonego,Lorenzo Sonego,Nikoloz Basilashvili,Rome Masters
0,3,3,0.0,0,1,1,0.0,Nikoloz Basilashvili,Lorenzo Sonego,Nikoloz Basilashvili,Rome Masters
2,2,4,50.0,0,0,0,,Casper Ruud,Casper Ruud,Karen Khachanov,Rome Masters
4,2,6,66.66666666666667,0,0,0,,Karen Khachanov,Casper Ruud,Karen Khachanov,Rome Masters
5,2,7,71.42857142857143,0,0,0,,Borna Coric,Borna Coric,Christian Garin,Rome Masters
1,2,3,33.333333333333336,0,0,0,,Christian Garin,Borna Coric,Christian Garin,Rome Masters
0,1,1,0.0,0,0,0,,Stefano Travaglia,Stefano Travaglia,Taylor Fritz,Rome Masters
3,2,5,60.0,0,0,0,,Taylor Fritz,Stefano Travaglia,Taylor Fritz,Rome Masters
1,1,2,50.0,0,0,0,,Federico Coria,Federico Coria,Jan Lennard Struff,Rome Masters
5,2,7,71.42857142857143,0,0,0,,Jan Lennard Struff,Federico Coria,Jan Lennard Struff,Rome Masters
0,1,1,0.0,0,0,0,,Dominik Koepfer,Dominik Koepfer,Alex De Minaur,Rome Masters
4,2,6,66.66666666666667,0,0,0,,Alex De Minaur,Dominik Koepfer,Alex De Minaur,Rome Masters
0,1,1,0.0,0,1,1,0.0,Kei Nishikori,Kei Nishikori,Albert Ramos,Rome Masters
0,2,2,0.0,0,1,1,0.0,Albert Ramos,Kei Nishikori,Albert Ramos,Rome Masters
0,0,0,,0,0,0,,Lorenzo Musetti,Lorenzo Musetti,Stan Wawrinka,Rome Masters
0,0,0,,0,0,0,,Stan Wawrinka,Lorenzo Musetti,Stan Wawrinka,Rome Masters
5,2,7,71.42857142857143,0,0,0,,Filip Krajinovic,Filip Krajinovic,Felix Auger Aliassime,Rome Masters
4,2,6,66.66666666666667,0,0,0,,Felix Auger Aliassime,Filip Krajinovic,Felix Auger Aliassime,Rome Masters
0,1,1,0.0,0,0,0,,Marco Cecchinato,Marco Cecchinato,Kyle Edmund,Rome Masters
1,2,3,33.333333333333336,0,0,0,,Kyle Edmund,Marco Cecchinato,Kyle Edmund,Rome Masters
2,2,4,50.0,0,0,0,,Salvatore Caruso,Salvatore Caruso,Tennys Sandgren,Rome Masters
2,2,4,50.0,0,0,0,,Tennys Sandgren,Salvatore Caruso,Tennys Sandgren,Rome Masters
0,0,0,,0,0,0,,Rafael Nadal,Rafael Nadal,Pablo Carreno Busta,Rome Masters
6,2,8,75.0,0,0,0,,Pablo Carreno Busta,Rafael Nadal,Pablo Carreno Busta,Rome Masters
1,3,4,25.0,1,1,2,50.0,Dusan Lajovic,Dusan Lajovic,Milos Raonic,Rome Masters
7,2,9,77.77777777777777,1,0,1,100.0,Milos Raonic,Dusan Lajovic,Milos Raonic,Rome Masters
3,3,6,50.0,2,1,3,66.66666666666667,Hubert Hurkacz,Hubert Hurkacz,Andrey Rublev,Rome Masters
5,2,7,71.42857142857143,1,0,1,100.0,Andrey Rublev,Hubert Hurkacz,Andrey Rublev,Rome Masters
2,3,5,40.0,1,1,2,50.0,Diego Schwartzman,Diego Schwartzman,John Millman,Rome Masters
3,3,6,50.0,1,1,2,50.0,John Millman,Diego Schwartzman,John Millman,Rome Masters
2,2,4,50.0,2,1,3,66.66666666666667,Jannik Sinner,Jannik Sinner,Stefanos Tsitsipas,Rome Masters
5,2,7,71.42857142857143,0,0,0,,Stefanos Tsitsipas,Jannik Sinner,Stefanos Tsitsipas,Rome Masters
3,2,5,60.0,1,0,1,100.0,Grigor Dimitrov,Grigor Dimitrov,Yoshihito Nishioka,Rome Masters
1,2,3,33.333333333333336,1,1,2,50.0,Yoshihito Nishioka,Grigor Dimitrov,Yoshihito Nishioka,Rome Masters
6,2,8,75.0,1,0,1,100.0,Denis Shapovalov,Denis Shapovalov,Pedro Martinez,Rome Masters
1,1,2,50.0,1,0,1,100.0,Pedro Martinez,Denis Shapovalov,Pedro Martinez,Rome Masters
2,2,4,50.0,1,0,1,100.0,Ugo Humbert,Ugo Humbert,Fabio Fognini,Rome Masters
0,1,1,0.0,0,1,1,0.0,Fabio Fognini,Ugo Humbert,Fabio Fognini,Rome Masters
3,2,5,60.0,1,0,1,100.0,Marin Cilic,Marin Cilic,David Goffin,Rome Masters
4,2,6,66.66666666666667,0,0,0,,David Goffin,Marin Cilic,David Goffin,Rome Masters
3,2,5,60.0,1,0,1,100.0,Casper Ruud,Casper Ruud,Lorenzo Sonego,Rome Masters
1,2,3,33.333333333333336,1,0,1,100.0,Lorenzo Sonego,Casper Ruud,Lorenzo Sonego,Rome Masters
1,1,2,50.0,1,0,1,100.0,Stefano Travaglia,Stefano Travaglia,Borna Coric,Rome Masters
6,2,8,75.0,1,0,1,100.0,Borna Coric,Stefano Travaglia,Borna Coric,Rome Masters
4,2,6,66.66666666666667,0,0,0,,Matteo Berrettini,Matteo Berrettini,Federico Coria,Rome Masters
2,1,3,66.66666666666667,1,0,1,100.0,Federico Coria,Matteo Berrettini,Federico Coria,Rome Masters
1,1,2,50.0,1,0,1,100.0,Dominik Koepfer,Dominik Koepfer,Gael Monfils,Rome Masters
0,0,0,,0,0,0,,Gael Monfils,Dominik Koepfer,Gael Monfils,Rome Masters
1,0,1,100.0,1,0,1,100.0,Lorenzo Musetti,Lorenzo Musetti,Kei Nishikori,Rome Masters
1,1,2,50.0,1,1,2,50.0,Kei Nishikori,Lorenzo Musetti,Kei Nishikori,Rome Masters
6,2,8,75.0,1,0,1,100.0,Filip Krajinovic,Filip Krajinovic,Marco Cecchinato,Rome Masters
1,1,2,50.0,1,0,1,100.0,Marco Cecchinato,Filip Krajinovic,Marco Cecchinato,Rome Masters
8,1,9,88.88888888888889,0,0,0,,Novak Djokovic,Novak Djokovic,Salvatore Caruso,Rome Masters
3,2,5,60.0,1,0,1,100.0,Salvatore Caruso,Novak Djokovic,Salvatore Caruso,Rome Masters
1,0,1,100.0,1,0,1,100.0,Rafael Nadal,Rafael Nadal,Dusan Lajovic,Rome Masters
2,3,5,40.0,2,1,3,66.66666666666667,Dusan Lajovic,Rafael Nadal,Dusan Lajovic,Rome Masters
3,3,6,50.0,2,1,3,66.66666666666667,Diego Schwartzman,Diego Schwartzman,Hubert Hurkacz,Rome Masters
4,3,7,57.142857142857146,3,1,4,75.0,Hubert Hurkacz,Diego Schwartzman,Hubert Hurkacz,Rome Masters
4,2,6,66.66666666666667,2,0,2,100.0,Grigor Dimitrov,Grigor Dimitrov,Jannik Sinner,Rome Masters
3,2,5,60.0,3,1,4,75.0,Jannik Sinner,Grigor Dimitrov,Jannik Sinner,Rome Masters
7,2,9,77.77777777777777,2,0,2,100.0,Denis Shapovalov,Denis Shapovalov,Ugo Humbert,Rome Masters
3,2,5,60.0,2,0,2,100.0,Ugo Humbert,Denis Shapovalov,Ugo Humbert,Rome Masters
4,2,6,66.66666666666667,2,0,2,100.0,Casper Ruud,Casper Ruud,Marin Cilic,Rome Masters
4,2,6,66.66666666666667,2,0,2,100.0,Marin Cilic,Casper Ruud,Marin Cilic,Rome Masters
5,2,7,71.42857142857143,1,0,1,100.0,Matteo Berrettini,Matteo Berrettini,Stefano Travaglia,Rome Masters
2,1,3,66.66666666666667,2,0,2,100.0,Stefano Travaglia,Matteo Berrettini,Stefano Travaglia,Rome Masters
2,1,3,66.66666666666667,2,0,2,100.0,Dominik Koepfer,Dominik Koepfer,Lorenzo Musetti,Rome Masters
2,0,2,100.0,2,0,2,100.0,Lorenzo Musetti,Dominik Koepfer,Lorenzo Musetti,Rome Masters
9,1,10,90.0,1,0,1,100.0,Novak Djokovic,Novak Djokovic,Filip Krajinovic,Rome Masters
7,2,9,77.77777777777777,2,0,2,100.0,Filip Krajinovic,Novak Djokovic,Filip Krajinovic,Rome Masters
4,3,7,57.142857142857146,3,1,4,75.0,Diego Schwartzman,Diego Schwartzman,Rafael Nadal,Rome Masters
2,0,2,100.0,2,0,2,100.0,Rafael Nadal,Diego Schwartzman,Rafael Nadal,Rome Masters
8,2,10,80.0,3,0,3,100.0,Denis Shapovalov,Denis Shapovalov,Grigor Dimitrov,Rome Masters
5,2,7,71.42857142857143,3,0,3,100.0,Grigor Dimitrov,Denis Shapovalov,Grigor Dimitrov,Rome Masters
5,2,7,71.42857142857143,3,0,3,100.0,Casper Ruud,Casper Ruud,Matteo Berrettini,Rome Masters
6,2,8,75.0,2,0,2,100.0,Matteo Berrettini,Casper Ruud,Matteo Berrettini,Rome Masters
10,1,11,90.9090909090909,2,0,2,100.0,Novak Djokovic,Novak Djokovic,Dominik Koepfer,Rome Masters
3,1,4,75.0,3,0,3,100.0,Dominik Koepfer,Novak Djokovic,Dominik Koepfer,Rome Masters
5,3,8,62.5,4,1,5,80.0,Diego Schwartzman,Diego Schwartzman,Denis Shapovalov,Rome Masters
9,2,11,81.81818181818181,4,0,4,100.0,Denis Shapovalov,Diego Schwartzman,Denis Shapovalov,Rome Masters
11,1,12,91.66666666666667,3,0,3,100.0,Novak Djokovic,Novak Djokovic,Casper Ruud,Rome Masters
6,2,8,75.0,4,0,4,100.0,Casper Ruud,Novak Djokovic,Casper Ruud,Rome Masters
12,1,13,92.3076923076923,4,0,4,100.0,Novak Djokovic,Novak Djokovic,Diego Schwartzman,Rome Masters
6,3,9,66.66666666666667,5,1,6,83.33333333333333,Diego Schwartzman,Novak Djokovic,Diego Schwartzman,Rome Masters
5,3,8,62.5,0,1,1,0.0,Stefanos Tsitsipas,Stefanos Tsitsipas,Daniel Evans,Hamburg
2,3,5,40.0,0,1,1,0.0,Daniel Evans,Stefanos Tsitsipas,Daniel Evans,Hamburg
0,1,1,0.0,0,0,0,,Pablo Cuevas,Pablo Cuevas,Taylor Fritz,Hamburg
3,3,6,50.0,0,1,1,0.0,Taylor Fritz,Pablo Cuevas,Taylor Fritz,Hamburg
2,4,6,33.333333333333336,2,2,4,50.0,Dusan Lajovic,Dusan Lajovic,Adrian Mannarino,Hamburg
2,3,5,40.0,0,1,1,0.0,Adrian Mannarino,Dusan Lajovic,Adrian Mannarino,Hamburg
4,3,7,57.142857142857146,0,1,1,0.0,Karen Khachanov,Karen Khachanov,Jan Lennard Struff,Hamburg
5,3,8,62.5,0,1,1,0.0,Jan Lennard Struff,Karen Khachanov,Jan Lennard Struff,Hamburg
4,1,5,80.0,4,1,5,80.0,Yannick Hanfmann,Yannick Hanfmann,Gael Monfils,Hamburg
0,1,1,0.0,0,1,1,0.0,Gael Monfils,Yannick Hanfmann,Gael Monfils,Hamburg
1,3,4,25.0,0,1,1,0.0,Christian Garin,Christian Garin,Kei Nishikori,Hamburg
1,2,3,33.333333333333336,1,2,3,33.333333333333336,Kei Nishikori,Christian Garin,Kei Nishikori,Hamburg
4,3,7,57.142857142857146,0,1,1,0.0,Felix Auger Aliassime,Felix Auger Aliassime,Lorenzo Sonego,Hamburg
1,3,4,25.0,1,1,2,50.0,Lorenzo Sonego,Felix Auger Aliassime,Lorenzo Sonego,Hamburg
0,4,4,0.0,0,2,2,0.0,Alexander Bublik,Alexander Bublik,Albert Ramos,Hamburg
0,3,3,0.0,0,2,2,0.0,Albert Ramos,Alexander Bublik,Albert Ramos,Hamburg
5,3,8,62.5,1,1,2,50.0,Andrey Rublev,Andrey Rublev,Tennys Sandgren,Hamburg
2,3,5,40.0,0,1,1,0.0,Tennys Sandgren,Andrey Rublev,Tennys Sandgren,Hamburg
0,2,2,0.0,0,0,0,,Tommy Paul,Tommy Paul,Kevin Anderson,Hamburg
1,3,4,25.0,0,1,1,0.0,Kevin Anderson,Tommy Paul,Kevin Anderson,Hamburg
3,2,5,60.0,3,1,4,75.0,Dominik Koepfer,Dominik Koepfer,Yoshihito Nishioka,Hamburg
1,3,4,25.0,1,2,3,33.333333333333336,Yoshihito Nishioka,Dominik Koepfer,Yoshihito Nishioka,Hamburg
5,2,7,71.42857142857143,0,0,0,,Roberto Bautista Agut,Roberto Bautista Agut,Nikoloz Basilashvili,Hamburg
0,4,4,0.0,0,2,2,0.0,Nikoloz Basilashvili,Roberto Bautista Agut,Nikoloz Basilashvili,Hamburg
0,2,2,0.0,0,2,2,0.0,Fabio Fognini,Fabio Fognini,Philipp Kohlschreiber,Hamburg
0,2,2,0.0,0,1,1,0.0,Philipp Kohlschreiber,Fabio Fognini,Philipp Kohlschreiber,Hamburg
6,3,9,66.66666666666667,4,1,5,80.0,Casper Ruud,Casper Ruud,Benoit Paire,Hamburg
0,2,2,0.0,0,1,1,0.0,Benoit Paire,Casper Ruud,Benoit Paire,Hamburg
0,1,1,0.0,0,0,0,,Jiri Vesely,Jiri Vesely,Gilles Simon,Hamburg
1,1,2,50.0,0,0,0,,Gilles Simon,Jiri Vesely,Gilles Simon,Hamburg
3,3,6,50.0,2,1,3,66.66666666666667,Ugo Humbert,Ugo Humbert,Daniil Medvedev,Hamburg
7,2,9,77.77777777777777,0,0,0,,Daniil Medvedev,Ugo Humbert,Daniil Medvedev,Hamburg
6,3,9,66.66666666666667,1,1,2,50.0,Stefanos Tsitsipas,Stefanos Tsitsipas,Pablo Cuevas,Hamburg
1,1,2,50.0,1,0,1,100.0,Pablo Cuevas,Stefanos Tsitsipas,Pablo Cuevas,Hamburg
3,4,7,42.857142857142854,3,2,5,60.0,Dusan Lajovic,Dusan Lajovic,Karen Khachanov,Hamburg
5,3,8,62.5,1,1,2,50.0,Karen Khachanov,Dusan Lajovic,Karen Khachanov,Hamburg
2,3,5,40.0,1,1,2,50.0,Christian Garin,Christian Garin,Yannick Hanfmann,Hamburg
5,1,6,83.33333333333333,5,1,6,83.33333333333333,Yannick Hanfmann,Christian Garin,Yannick Hanfmann,Hamburg
1,4,5,20.0,1,2,3,33.333333333333336,Alexander Bublik,Alexander Bublik,Felix Auger Aliassime,Hamburg
5,3,8,62.5,1,1,2,50.0,Felix Auger Aliassime,Alexander Bublik,Felix Auger Aliassime,Hamburg
6,3,9,66.66666666666667,2,1,3,66.66666666666667,Andrey Rublev,Andrey Rublev,Tommy Paul,Hamburg
1,2,3,33.333333333333336,1,0,1,100.0,Tommy Paul,Andrey Rublev,Tommy Paul,Hamburg
6,2,8,75.0,1,0,1,100.0,Roberto Bautista Agut,Roberto Bautista Agut,Dominik Koepfer,Hamburg
4,2,6,66.66666666666667,4,1,5,80.0,Dominik Koepfer,Roberto Bautista Agut,Dominik Koepfer,Hamburg
7,3,10,70.0,5,1,6,83.33333333333333,Casper Ruud,Casper Ruud,Fabio Fognini,Hamburg
1,2,3,33.333333333333336,1,2,3,33.333333333333336,Fabio Fognini,Casper Ruud,Fabio Fognini,Hamburg
4,3,7,57.142857142857146,3,1,4,75.0,Ugo Humbert,Ugo Humbert,Jiri Vesely,Hamburg
1,1,2,50.0,1,0,1,100.0,Jiri Vesely,Ugo Humbert,Jiri Vesely,Hamburg
7,3,10,70.0,2,1,3,66.66666666666667,Stefanos Tsitsipas,Stefanos Tsitsipas,Dusan Lajovic,Hamburg
4,4,8,50.0,4,2,6,66.66666666666667,Dusan Lajovic,Stefanos Tsitsipas,Dusan Lajovic,Hamburg
3,3,6,50.0,2,1,3,66.66666666666667,Christian Garin,Christian Garin,Alexander Bublik,Hamburg
2,4,6,33.333333333333336,2,2,4,50.0,Alexander Bublik,Christian Garin,Alexander Bublik,Hamburg
7,3,10,70.0,3,1,4,75.0,Andrey Rublev,Andrey Rublev,Roberto Bautista Agut,Hamburg
7,2,9,77.77777777777777,2,0,2,100.0,Roberto Bautista Agut,Andrey Rublev,Roberto Bautista Agut,Hamburg
8,3,11,72.72727272727273,6,1,7,85.71428571428571,Casper Ruud,Casper Ruud,Ugo Humbert,Hamburg
5,3,8,62.5,4,1,5,80.0,Ugo Humbert,Casper Ruud,Ugo Humbert,Hamburg
8,3,11,72.72727272727273,3,1,4,75.0,Stefanos Tsitsipas,Stefanos Tsitsipas,Christian Garin,Hamburg
4,3,7,57.142857142857146,3,1,4,75.0,Christian Garin,Stefanos Tsitsipas,Christian Garin,Hamburg
8,3,11,72.72727272727273,4,1,5,80.0,Andrey Rublev,Andrey Rublev,Casper Ruud,Hamburg
9,3,12,75.0,7,1,8,87.5,Casper Ruud,Andrey Rublev,Casper Ruud,Hamburg
9,3,12,75.0,5,1,6,83.33333333333333,Andrey Rublev,Andrey Rublev,Stefanos Tsitsipas,Hamburg
9,3,12,75.0,4,1,5,80.0,Stefanos Tsitsipas,Andrey Rublev,Stefanos Tsitsipas,Hamburg
13,1,14,92.85714285714286,5,0,5,100.0,Novak Djokovic,Novak Djokovic,Mikael Ymer,Roland Garros
0,1,1,0.0,0,0,0,,Mikael Ymer,Novak Djokovic,Mikael Ymer,Roland Garros
3,2,5,60.0,0,0,0,,Ricardas Berankis,Ricardas Berankis,Hugo Dellien,Roland Garros
0,1,1,0.0,0,0,0,,Hugo Dellien,Ricardas Berankis,Hugo Dellien,Roland Garros
0,0,0,,0,0,0,,Daniel Elahi Galan,Daniel Elahi Galan,Cameron Norrie,Roland Garros
2,2,4,50.0,0,0,0,,Cameron Norrie,Daniel Elahi Galan,Cameron Norrie,Roland Garros
2,4,6,33.333333333333336,0,2,2,0.0,Tennys Sandgren,Tennys Sandgren,Hubert Hurkacz,Roland Garros
4,4,8,50.0,3,2,5,60.0,Hubert Hurkacz,Tennys Sandgren,Hubert Hurkacz,Roland Garros
4,4,8,50.0,3,2,5,60.0,Christian Garin,Christian Garin,Philipp Kohlschreiber,Roland Garros
0,3,3,0.0,0,2,2,0.0,Philipp Kohlschreiber,Christian Garin,Philipp Kohlschreiber,Roland Garros
0,1,1,0.0,0,0,0,,Marc Polmans,Marc Polmans,Ugo Humbert,Roland Garros
5,4,9,55.55555555555556,4,2,6,66.66666666666667,Ugo Humbert,Marc Polmans,Ugo Humbert,Roland Garros
1,2,3,33.333333333333336,1,1,2,50.0,Jiri Vesely,Jiri Vesely,Liam Broady,Roland Garros
0,0,0,,0,0,0,,Liam Broady,Jiri Vesely,Liam Broady,Roland Garros
5,4,9,55.55555555555556,1,2,3,33.333333333333336,Karen Khachanov,Karen Khachanov,Kamil Majchrzak,Roland Garros
0,1,1,0.0,0,0,0,,Kamil Majchrzak,Karen Khachanov,Kamil Majchrzak,Roland Garros
7,3,10,70.0,2,1,3,66.66666666666667,Roberto Bautista Agut,Roberto Bautista Agut,Richard Gasquet,Roland Garros
2,2,4,50.0,0,0,0,,Richard Gasquet,Roberto Bautista Agut,Richard Gasquet,Roland Garros
0,1,1,0.0,0,0,0,,Attila Balazs,Attila Balazs,Yasutaka Uchiyama,Roland Garros
0,1,1,0.0,0,0,0,,Yasutaka Uchiyama,Attila Balazs,Yasutaka Uchiyama,Roland Garros
1,3,4,25.0,1,2,3,33.333333333333336,Guido Pella,Guido Pella,Salvatore Caruso,Roland Garros
3,3,6,50.0,1,1,2,50.0,Salvatore Caruso,Guido Pella,Salvatore Caruso,Roland Garros
6,3,9,66.66666666666667,0,1,1,0.0,Pablo Carreno Busta,Pablo Carreno Busta,John Millman,Roland Garros
3,4,7,42.857142857142854,1,2,3,33.333333333333336,John Millman,Pablo Carreno Busta,John Millman,Roland Garros
5,4,9,55.55555555555556,0,2,2,0.0,Jan Lennard Struff,Jan Lennard Struff,Frances Tiafoe,Roland Garros
3,2,5,60.0,0,0,0,,Frances Tiafoe,Jan Lennard Struff,Frances Tiafoe,Roland Garros
0,0,0,,0,0,0,,Daniel Altmaier,Daniel Altmaier,Feliciano Lopez,Roland Garros
2,2,4,50.0,2,1,3,66.66666666666667,Feliciano Lopez,Daniel Altmaier,Feliciano Lopez,Roland Garros
1,2,3,33.333333333333336,0,0,0,,Lloyd Harris,Lloyd Harris,Alexei Popyrin,Roland Garros
0,0,0,,0,0,0,,Alexei Popyrin,Lloyd Harris,Alexei Popyrin,Roland Garros
6,3,9,66.66666666666667,2,1,3,66.66666666666667,Matteo Berrettini,Matteo Berrettini,Vasek Pospisil,Roland Garros
3,1,4,75.0,0,0,0,,Vasek Pospisil,Matteo Berrettini,Vasek Pospisil,Roland Garros
4,2,6,66.66666666666667,0,0,0,,Marton Fucsovics,Marton Fucsovics,Daniil Medvedev,Roland Garros
7,3,10,70.0,0,1,1,0.0,Daniil Medvedev,Marton Fucsovics,Daniil Medvedev,Roland Garros
0,4,4,0.0,0,3,3,0.0,Albert Ramos,Albert Ramos,Adrian Mannarino,Roland Garros
2,4,6,33.333333333333336,0,2,2,0.0,Adrian Mannarino,Albert Ramos,Adrian Mannarino,Roland Garros
2,2,4,50.0,0,0,0,,Marcos Giron,Marcos Giron,Quentin Halys,Roland Garros
0,0,0,,0,0,0,,Quentin Halys,Marcos Giron,Quentin Halys,Roland Garros
0,1,1,0.0,0,0,0,,Thiago Monteiro,Thiago Monteiro,Nikoloz Basilashvili,Roland Garros
0,5,5,0.0,0,3,3,0.0,Nikoloz Basilashvili,Thiago Monteiro,Nikoloz Basilashvili,Roland Garros
4,5,9,44.44444444444444,4,3,7,57.142857142857146,Dusan Lajovic,Dusan Lajovic,Gianluca Mager,Roland Garros
0,2,2,0.0,0,1,1,0.0,Gianluca Mager,Dusan Lajovic,Gianluca Mager,Roland Garros
1,4,5,20.0,0,2,2,0.0,Kevin Anderson,Kevin Anderson,Laslo Djere,Roland Garros
3,2,5,60.0,3,1,4,75.0,Laslo Djere,Kevin Anderson,Laslo Djere,Roland Garros
3,2,5,60.0,0,1,1,0.0,Alejandro Davidovich Fokina,Alejandro Davidovich Fokina,Harold Mayot,Roland Garros
0,0,0,,0,0,0,,Harold Mayot,Alejandro Davidovich Fokina,Harold Mayot,Roland Garros
10,3,13,76.92307692307692,6,1,7,85.71428571428571,Andrey Rublev,Andrey Rublev,Sam Querrey,Roland Garros
0,3,3,0.0,0,1,1,0.0,Sam Querrey,Andrey Rublev,Sam Querrey,Roland Garros
9,3,12,75.0,4,1,5,80.0,Denis Shapovalov,Denis Shapovalov,Gilles Simon,Roland Garros
1,2,3,33.333333333333336,0,1,1,0.0,Gilles Simon,Denis Shapovalov,Gilles Simon,Roland Garros
1,1,2,50.0,0,0,0,,Roberto Carballes Baena,Roberto Carballes Baena,Steve Johnson,Roland Garros
1,1,2,50.0,0,0,0,,Steve Johnson,Roberto Carballes Baena,Steve Johnson,Roland Garros
0,1,1,0.0,0,0,0,,Andrej Martin,Andrej Martin,Joao Sousa,Roland Garros
0,3,3,0.0,0,2,2,0.0,Joao Sousa,Andrej Martin,Joao Sousa,Roland Garros
5,3,8,62.5,3,1,4,75.0,Grigor Dimitrov,Grigor Dimitrov,Gregoire Barrere,Roland Garros
1,1,2,50.0,0,0,0,,Gregoire Barrere,Grigor Dimitrov,Gregoire Barrere,Roland Garros
0,0,0,,0,0,0,,Nikola Milojevic,Nikola Milojevic,Filip Krajinovic,Roland Garros
7,3,10,70.0,2,1,3,66.66666666666667,Filip Krajinovic,Nikola Milojevic,Filip Krajinovic,Roland Garros
2,2,4,50.0,0,0,0,,Aljaz Bedene,Aljaz Bedene,Arthur Rinderknech,Roland Garros
0,0,0,,0,0,0,,Arthur Rinderknech,Aljaz Bedene,Arthur Rinderknech,Roland Garros
1,2,3,33.333333333333336,1,1,2,50.0,Pablo Cuevas,Pablo Cuevas,Henri Laaksonen,Roland Garros
0,0,0,,0,0,0,,Henri Laaksonen,Pablo Cuevas,Henri Laaksonen,Roland Garros
9,4,13,69.23076923076923,4,2,6,66.66666666666667,Stefanos Tsitsipas,Stefanos Tsitsipas,Jaume Munar,Roland Garros
0,1,1,0.0,0,0,0,,Jaume Munar,Stefanos Tsitsipas,Jaume Munar,Roland Garros
2,5,7,28.571428571428573,2,3,5,40.0,Alexander Bublik,Alexander Bublik,Gael Monfils,Roland Garros
0,2,2,0.0,0,2,2,0.0,Gael Monfils,Alexander Bublik,Gael Monfils,Roland Garros
1,4,5,20.0,1,2,3,33.333333333333336,Lorenzo Sonego,Lorenzo Sonego,Emilio Gomez,Roland Garros
0,0,0,,0,0,0,,Emilio Gomez,Lorenzo Sonego,Emilio Gomez,Roland Garros
0,2,2,0.0,0,1,1,0.0,Radu Albot,Radu Albot,Jordan Thompson,Roland Garros
4,2,6,66.66666666666667,1,1,2,50.0,Jordan Thompson,Radu Albot,Jordan Thompson,Roland Garros
3,4,7,42.857142857142854,0,2,2,0.0,Taylor Fritz,Taylor Fritz,Tomas Machac,Roland Garros
0,0,0,,0,0,0,,Tomas Machac,Taylor Fritz,Tomas Machac,Roland Garros
1,2,3,33.333333333333336,0,0,0,,Norbert Gombos,Norbert Gombos,Borna Coric,Roland Garros
6,3,9,66.66666666666667,1,1,2,50.0,Borna Coric,Norbert Gombos,Borna Coric,Roland Garros
0,0,0,,0,0,0,,Jurij Rodionov,Jurij Rodionov,Jeremy Chardy,Roland Garros
0,1,1,0.0,0,0,0,,Jeremy Chardy,Jurij Rodionov,Jeremy Chardy,Roland Garros
0,0,0,,0,0,0,,Lorenzo Giustino,Lorenzo Giustino,Corentin Moutet,Roland Garros
2,1,3,66.66666666666667,0,0,0,,Corentin Moutet,Lorenzo Giustino,Corentin Moutet,Roland Garros
6,4,10,60.0,5,2,7,71.42857142857143,Diego Schwartzman,Diego Schwartzman,Miomir Kecmanovic,Roland Garros
6,2,8,75.0,5,1,6,83.33333333333333,Miomir Kecmanovic,Diego Schwartzman,Miomir Kecmanovic,Roland Garros
0,1,1,0.0,0,1,1,0.0,Stan Wawrinka,Stan Wawrinka,Andy Murray,Roland Garros
3,2,5,60.0,0,0,0,,Andy Murray,Stan Wawrinka,Andy Murray,Roland Garros
4,3,7,57.142857142857146,4,2,6,66.66666666666667,Dominik Koepfer,Dominik Koepfer,Antoine Hoang,Roland Garros
0,0,0,,0,0,0,,Antoine Hoang,Dominik Koepfer,Antoine Hoang,Roland Garros
0,0,0,,0,0,0,,Hugo Gaston,Hugo Gaston,Maxime Janvier,Roland Garros
0,0,0,,0,0,0,,Maxime Janvier,Hugo Gaston,Maxime Janvier,Roland Garros
1,4,5,20.0,1,3,4,25.0,Yoshihito Nishioka,Yoshihito Nishioka,Felix Auger Aliassime,Roland Garros
5,4,9,55.55555555555556,1,2,3,33.333333333333336,Felix Auger Aliassime,Yoshihito Nishioka,Felix Auger Aliassime,Roland Garros
9,4,13,69.23076923076923,7,2,9,77.77777777777777,Casper Ruud,Casper Ruud,Yuichi Sugita,Roland Garros
0,1,1,0.0,0,0,0,,Yuichi Sugita,Casper Ruud,Yuichi Sugita,Roland Garros
1,3,4,25.0,1,1,2,50.0,Tommy Paul,Tommy Paul,James Duckworth,Roland Garros
0,1,1,0.0,0,0,0,,James Duckworth,Tommy Paul,James Duckworth,Roland Garros
1,1,2,50.0,0,0,0,,Jack Sock,Jack Sock,Reilly Opelka,Roland Garros
3,2,5,60.0,0,0,0,,Reilly Opelka,Jack Sock,Reilly Opelka,Roland Garros
7,1,8,87.5,0,0,0,,Dominic Thiem,Dominic Thiem,Marin Cilic,Roland Garros
4,3,7,57.142857142857146,2,1,3,66.66666666666667,Marin Cilic,Dominic Thiem,Marin Cilic,Roland Garros
6,2,8,75.0,0,0,0,,Alexander Zverev,Alexander Zverev,Dennis Novak,Roland Garros
0,2,2,0.0,0,1,1,0.0,Dennis Novak,Alexander Zverev,Dennis Novak,Roland Garros
0,1,1,0.0,0,1,1,0.0,Pierre Hugues Herbert,Pierre Hugues Herbert,Michael Mmoh,Roland Garros
1,1,2,50.0,0,0,0,,Michael Mmoh,Pierre Hugues Herbert,Michael Mmoh,Roland Garros
1,2,3,33.333333333333336,0,1,1,0.0,Juan Ignacio Londero,Juan Ignacio Londero,Federico Delbonis,Roland Garros
2,2,4,50.0,2,1,3,66.66666666666667,Federico Delbonis,Juan Ignacio Londero,Federico Delbonis,Roland Garros
1,2,3,33.333333333333336,1,1,2,50.0,Marco Cecchinato,Marco Cecchinato,Alex De Minaur,Roland Garros
4,3,7,57.142857142857146,0,1,1,0.0,Alex De Minaur,Marco Cecchinato,Alex De Minaur,Roland Garros
0,3,3,0.0,0,2,2,0.0,Benoit Paire,Benoit Paire,Soon Woo Kwon,Roland Garros
1,1,2,50.0,0,0,0,,Soon Woo Kwon,Benoit Paire,Soon Woo Kwon,Roland Garros
2,2,4,50.0,1,1,2,50.0,Federico Coria,Federico Coria,Jason Jung,Roland Garros
0,1,1,0.0,0,0,0,,Jason Jung,Federico Coria,Jason Jung,Roland Garros
0,0,0,,0,0,0,,Benjamin Bonzi,Benjamin Bonzi,Emil Ruusuvuori,Roland Garros
2,3,5,40.0,0,1,1,0.0,Emil Ruusuvuori,Benjamin Bonzi,Emil Ruusuvuori,Roland Garros
3,3,6,50.0,3,2,5,60.0,Jannik Sinner,Jannik Sinner,David Goffin,Roland Garros
4,3,7,57.142857142857146,0,1,1,0.0,David Goffin,Jannik Sinner,David Goffin,Roland Garros
2,1,3,66.66666666666667,0,0,0,,Mikhail Kukushkin,Mikhail Kukushkin,Fabio Fognini,Roland Garros
1,3,4,25.0,1,3,4,25.0,Fabio Fognini,Mikhail Kukushkin,Fabio Fognini,Roland Garros
1,2,3,33.333333333333336,1,1,2,50.0,Pedro Martinez,Pedro Martinez,Aleksandar Vukic,Roland Garros
0,0,0,,0,0,0,,Aleksandar Vukic,Pedro Martinez,Aleksandar Vukic,Roland Garros
0,2,2,0.0,0,0,0,,Sebastian Korda,Sebastian Korda,Andreas Seppi,Roland Garros
0,1,1,0.0,0,0,0,,Andreas Seppi,Sebastian Korda,Andreas Seppi,Roland Garros
2,2,4,50.0,0,0,0,,John Isner,John Isner,Elliot Benchetrit,Roland Garros
0,0,0,,0,0,0,,Elliot Benchetrit,John Isner,Elliot Benchetrit,Roland Garros
1,3,4,25.0,1,3,4,25.0,Kei Nishikori,Kei Nishikori,Daniel Evans,Roland Garros
2,4,6,33.333333333333336,0,2,2,0.0,Daniel Evans,Kei Nishikori,Daniel Evans,Roland Garros
2,2,4,50.0,2,1,3,66.66666666666667,Stefano Travaglia,Stefano Travaglia,Pablo Andujar,Roland Garros
0,1,1,0.0,0,0,0,,Pablo Andujar,Stefano Travaglia,Pablo Andujar,Roland Garros
0,2,2,0.0,0,0,0,,Mackenzie McDonald,Mackenzie McDonald,Steven Diez,Roland Garros
0,0,0,,0,0,0,,Steven Diez,Mackenzie McDonald,Steven Diez,Roland Garros
2,1,3,66.66666666666667,2,1,3,66.66666666666667,Rafael Nadal,Rafael Nadal,Egor Gerasimov,Roland Garros
1,1,2,50.0,0,0,0,,Egor Gerasimov,Rafael Nadal,Egor Gerasimov,Roland Garros
14,1,15,93.33333333333333,6,0,6,100.0,Novak Djokovic,Novak Djokovic,Ricardas Berankis,Roland Garros
4,2,6,66.66666666666667,1,0,1,100.0,Ricardas Berankis,Novak Djokovic,Ricardas Berankis,Roland Garros
1,0,1,100.0,1,0,1,100.0,Daniel Elahi Galan,Daniel Elahi Galan,Tennys Sandgren,Roland Garros
3,4,7,42.857142857142854,1,2,3,33.333333333333336,Tennys Sandgren,Daniel Elahi Galan,Tennys Sandgren,Roland Garros
5,4,9,55.55555555555556,4,2,6,66.66666666666667,Christian Garin,Christian Garin,Marc Polmans,Roland Garros
1,1,2,50.0,1,0,1,100.0,Marc Polmans,Christian Garin,Marc Polmans,Roland Garros
6,4,10,60.0,2,2,4,50.0,Karen Khachanov,Karen Khachanov,Jiri Vesely,Roland Garros
2,2,4,50.0,2,1,3,66.66666666666667,Jiri Vesely,Karen Khachanov,Jiri Vesely,Roland Garros
8,3,11,72.72727272727273,3,1,4,75.0,Roberto Bautista Agut,Roberto Bautista Agut,Attila Balazs,Roland Garros
1,1,2,50.0,1,0,1,100.0,Attila Balazs,Roberto Bautista Agut,Attila Balazs,Roland Garros
7,3,10,70.0,1,1,2,50.0,Pablo Carreno Busta,Pablo Carreno Busta,Guido Pella,Roland Garros
2,3,5,40.0,2,2,4,50.0,Guido Pella,Pablo Carreno Busta,Guido Pella,Roland Garros
1,0,1,100.0,1,0,1,100.0,Daniel Altmaier,Daniel Altmaier,Jan Lennard Struff,Roland Garros
6,4,10,60.0,1,2,3,33.333333333333336,Jan Lennard Struff,Daniel Altmaier,Jan Lennard Struff,Roland Garros
7,3,10,70.0,3,1,4,75.0,Matteo Berrettini,Matteo Berrettini,Lloyd Harris,Roland Garros
2,2,4,50.0,1,0,1,100.0,Lloyd Harris,Matteo Berrettini,Lloyd Harris,Roland Garros
5,2,7,71.42857142857143,1,0,1,100.0,Marton Fucsovics,Marton Fucsovics,Albert Ramos,Roland Garros
1,4,5,20.0,1,3,4,25.0,Albert Ramos,Marton Fucsovics,Albert Ramos,Roland Garros
1,1,2,50.0,1,0,1,100.0,Thiago Monteiro,Thiago Monteiro,Marcos Giron,Roland Garros
3,2,5,60.0,1,0,1,100.0,Marcos Giron,Thiago Monteiro,Marcos Giron,Roland Garros
2,4,6,33.333333333333336,1,2,3,33.333333333333336,Kevin Anderson,Kevin Anderson,Dusan Lajovic,Roland Garros
5,5,10,50.0,5,3,8,62.5,Dusan Lajovic,Kevin Anderson,Dusan Lajovic,Roland Garros
11,3,14,78.57142857142857,7,1,8,87.5,Andrey Rublev,Andrey Rublev,Alejandro Davidovich Fokina,Roland Garros
4,2,6,66.66666666666667,1,1,2,50.0,Alejandro Davidovich Fokina,Andrey Rublev,Alejandro Davidovich Fokina,Roland Garros
2,1,3,66.66666666666667,1,0,1,100.0,Roberto Carballes Baena,Roberto Carballes Baena,Denis Shapovalov,Roland Garros
10,3,13,76.92307692307692,5,1,6,83.33333333333333,Denis Shapovalov,Roberto Carballes Baena,Denis Shapovalov,Roland Garros
6,3,9,66.66666666666667,4,1,5,80.0,Grigor Dimitrov,Grigor Dimitrov,Andrej Martin,Roland Garros
1,1,2,50.0,1,0,1,100.0,Andrej Martin,Grigor Dimitrov,Andrej Martin,Roland Garros
3,2,5,60.0,1,0,1,100.0,Aljaz Bedene,Aljaz Bedene,Nikola Milojevic,Roland Garros
1,0,1,100.0,1,0,1,100.0,Nikola Milojevic,Aljaz Bedene,Nikola Milojevic,Roland Garros
10,4,14,71.42857142857143,5,2,7,71.42857142857143,Stefanos Tsitsipas,Stefanos Tsitsipas,Pablo Cuevas,Roland Garros
2,2,4,50.0,2,1,3,66.66666666666667,Pablo Cuevas,Stefanos Tsitsipas,Pablo Cuevas,Roland Garros
2,4,6,33.333333333333336,2,2,4,50.0,Lorenzo Sonego,Lorenzo Sonego,Alexander Bublik,Roland Garros
3,5,8,37.5,3,3,6,50.0,Alexander Bublik,Lorenzo Sonego,Alexander Bublik,Roland Garros
4,4,8,50.0,1,2,3,33.333333333333336,Taylor Fritz,Taylor Fritz,Radu Albot,Roland Garros
1,2,3,33.333333333333336,1,1,2,50.0,Radu Albot,Taylor Fritz,Radu Albot,Roland Garros
2,2,4,50.0,1,0,1,100.0,Norbert Gombos,Norbert Gombos,Jurij Rodionov,Roland Garros
1,0,1,100.0,1,0,1,100.0,Jurij Rodionov,Norbert Gombos,Jurij Rodionov,Roland Garros
7,4,11,63.63636363636363,6,2,8,75.0,Diego Schwartzman,Diego Schwartzman,Lorenzo Giustino,Roland Garros
1,0,1,100.0,1,0,1,100.0,Lorenzo Giustino,Diego Schwartzman,Lorenzo Giustino,Roland Garros
1,1,2,50.0,1,1,2,50.0,Stan Wawrinka,Stan Wawrinka,Dominik Koepfer,Roland Garros
5,3,8,62.5,5,2,7,71.42857142857143,Dominik Koepfer,Stan Wawrinka,Dominik Koepfer,Roland Garros
1,0,1,100.0,1,0,1,100.0,Hugo Gaston,Hugo Gaston,Yoshihito Nishioka,Roland Garros
2,4,6,33.333333333333336,2,3,5,40.0,Yoshihito Nishioka,Hugo Gaston,Yoshihito Nishioka,Roland Garros
10,4,14,71.42857142857143,8,2,10,80.0,Casper Ruud,Casper Ruud,Tommy Paul,Roland Garros
2,3,5,40.0,2,1,3,66.66666666666667,Tommy Paul,Casper Ruud,Tommy Paul,Roland Garros
8,1,9,88.88888888888889,1,0,1,100.0,Dominic Thiem,Dominic Thiem,Jack Sock,Roland Garros
2,1,3,66.66666666666667,1,0,1,100.0,Jack Sock,Dominic Thiem,Jack Sock,Roland Garros
7,2,9,77.77777777777777,1,0,1,100.0,Alexander Zverev,Alexander Zverev,Pierre Hugues Herbert,Roland Garros
1,1,2,50.0,1,1,2,50.0,Pierre Hugues Herbert,Alexander Zverev,Pierre Hugues Herbert,Roland Garros
2,2,4,50.0,2,1,3,66.66666666666667,Marco Cecchinato,Marco Cecchinato,Juan Ignacio Londero,Roland Garros
2,2,4,50.0,1,1,2,50.0,Juan Ignacio Londero,Marco Cecchinato,Juan Ignacio Londero,Roland Garros
3,2,5,60.0,2,1,3,66.66666666666667,Federico Coria,Federico Coria,Benoit Paire,Roland Garros
1,3,4,25.0,1,2,3,33.333333333333336,Benoit Paire,Federico Coria,Benoit Paire,Roland Garros
4,3,7,57.142857142857146,4,2,6,66.66666666666667,Jannik Sinner,Jannik Sinner,Benjamin Bonzi,Roland Garros
1,0,1,100.0,1,0,1,100.0,Benjamin Bonzi,Jannik Sinner,Benjamin Bonzi,Roland Garros
2,2,4,50.0,2,1,3,66.66666666666667,Pedro Martinez,Pedro Martinez,Mikhail Kukushkin,Roland Garros
3,1,4,75.0,1,0,1,100.0,Mikhail Kukushkin,Pedro Martinez,Mikhail Kukushkin,Roland Garros
1,2,3,33.333333333333336,1,0,1,100.0,Sebastian Korda,Sebastian Korda,John Isner,Roland Garros
3,2,5,60.0,1,0,1,100.0,John Isner,Sebastian Korda,John Isner,Roland Garros
3,2,5,60.0,3,1,4,75.0,Stefano Travaglia,Stefano Travaglia,Kei Nishikori,Roland Garros
2,3,5,40.0,2,3,5,40.0,Kei Nishikori,Stefano Travaglia,Kei Nishikori,Roland Garros
3,1,4,75.0,3,1,4,75.0,Rafael Nadal,Rafael Nadal,Mackenzie McDonald,Roland Garros
1,2,3,33.333333333333336,1,0,1,100.0,Mackenzie McDonald,Rafael Nadal,Mackenzie McDonald,Roland Garros
15,1,16,93.75,7,0,7,100.0,Novak Djokovic,Novak Djokovic,Daniel Elahi Galan,Roland Garros
2,0,2,100.0,2,0,2,100.0,Daniel Elahi Galan,Novak Djokovic,Daniel Elahi Galan,Roland Garros
7,4,11,63.63636363636363,3,2,5,60.0,Karen Khachanov,Karen Khachanov,Christian Garin,Roland Garros
6,4,10,60.0,5,2,7,71.42857142857143,Christian Garin,Karen Khachanov,Christian Garin,Roland Garros
8,3,11,72.72727272727273,2,1,3,66.66666666666667,Pablo Carreno Busta,Pablo Carreno Busta,Roberto Bautista Agut,Roland Garros
9,3,12,75.0,4,1,5,80.0,Roberto Bautista Agut,Pablo Carreno Busta,Roberto Bautista Agut,Roland Garros
2,0,2,100.0,2,0,2,100.0,Daniel Altmaier,Daniel Altmaier,Matteo Berrettini,Roland Garros
8,3,11,72.72727272727273,4,1,5,80.0,Matteo Berrettini,Daniel Altmaier,Matteo Berrettini,Roland Garros
6,2,8,75.0,2,0,2,100.0,Marton Fucsovics,Marton Fucsovics,Thiago Monteiro,Roland Garros
2,1,3,66.66666666666667,2,0,2,100.0,Thiago Monteiro,Marton Fucsovics,Thiago Monteiro,Roland Garros
12,3,15,80.0,8,1,9,88.88888888888889,Andrey Rublev,Andrey Rublev,Kevin Anderson,Roland Garros
3,4,7,42.857142857142854,2,2,4,50.0,Kevin Anderson,Andrey Rublev,Kevin Anderson,Roland Garros
7,3,10,70.0,5,1,6,83.33333333333333,Grigor Dimitrov,Grigor Dimitrov,Roberto Carballes Baena,Roland Garros
3,1,4,75.0,2,0,2,100.0,Roberto Carballes Baena,Grigor Dimitrov,Roberto Carballes Baena,Roland Garros
11,4,15,73.33333333333333,6,2,8,75.0,Stefanos Tsitsipas,Stefanos Tsitsipas,Aljaz Bedene,Roland Garros
4,2,6,66.66666666666667,2,0,2,100.0,Aljaz Bedene,Stefanos Tsitsipas,Aljaz Bedene,Roland Garros
3,4,7,42.857142857142854,3,2,5,60.0,Lorenzo Sonego,Lorenzo Sonego,Taylor Fritz,Roland Garros
5,4,9,55.55555555555556,2,2,4,50.0,Taylor Fritz,Lorenzo Sonego,Taylor Fritz,Roland Garros
8,4,12,66.66666666666667,7,2,9,77.77777777777777,Diego Schwartzman,Diego Schwartzman,Norbert Gombos,Roland Garros
3,2,5,60.0,2,0,2,100.0,Norbert Gombos,Diego Schwartzman,Norbert Gombos,Roland Garros
2,0,2,100.0,2,0,2,100.0,Hugo Gaston,Hugo Gaston,Stan Wawrinka,Roland Garros
2,1,3,66.66666666666667,2,1,3,66.66666666666667,Stan Wawrinka,Hugo Gaston,Stan Wawrinka,Roland Garros
9,1,10,90.0,2,0,2,100.0,Dominic Thiem,Dominic Thiem,Casper Ruud,Roland Garros
11,4,15,73.33333333333333,9,2,11,81.81818181818181,Casper Ruud,Dominic Thiem,Casper Ruud,Roland Garros
8,2,10,80.0,2,0,2,100.0,Alexander Zverev,Alexander Zverev,Marco Cecchinato,Roland Garros
3,2,5,60.0,3,1,4,75.0,Marco Cecchinato,Alexander Zverev,Marco Cecchinato,Roland Garros
5,3,8,62.5,5,2,7,71.42857142857143,Jannik Sinner,Jannik Sinner,Federico Coria,Roland Garros
4,2,6,66.66666666666667,3,1,4,75.0,Federico Coria,Jannik Sinner,Federico Coria,Roland Garros
2,2,4,50.0,2,0,2,100.0,Sebastian Korda,Sebastian Korda,Pedro Martinez,Roland Garros
3,2,5,60.0,3,1,4,75.0,Pedro Martinez,Sebastian Korda,Pedro Martinez,Roland Garros
4,1,5,80.0,4,1,5,80.0,Rafael Nadal,Rafael Nadal,Stefano Travaglia,Roland Garros
4,2,6,66.66666666666667,4,1,5,80.0,Stefano Travaglia,Rafael Nadal,Stefano Travaglia,Roland Garros
16,1,17,94.11764705882354,8,0,8,100.0,Novak Djokovic,Novak Djokovic,Karen Khachanov,Roland Garros
8,4,12,66.66666666666667,4,2,6,66.66666666666667,Karen Khachanov,Novak Djokovic,Karen Khachanov,Roland Garros
9,3,12,75.0,3,1,4,75.0,Pablo Carreno Busta,Pablo Carreno Busta,Daniel Altmaier,Roland Garros
3,0,3,100.0,3,0,3,100.0,Daniel Altmaier,Pablo Carreno Busta,Daniel Altmaier,Roland Garros
13,3,16,81.25,9,1,10,90.0,Andrey Rublev,Andrey Rublev,Marton Fucsovics,Roland Garros
7,2,9,77.77777777777777,3,0,3,100.0,Marton Fucsovics,Andrey Rublev,Marton Fucsovics,Roland Garros
12,4,16,75.0,7,2,9,77.77777777777777,Stefanos Tsitsipas,Stefanos Tsitsipas,Grigor Dimitrov,Roland Garros
8,3,11,72.72727272727273,6,1,7,85.71428571428571,Grigor Dimitrov,Stefanos Tsitsipas,Grigor Dimitrov,Roland Garros
9,4,13,69.23076923076923,8,2,10,80.0,Diego Schwartzman,Diego Schwartzman,Lorenzo Sonego,Roland Garros
4,4,8,50.0,4,2,6,66.66666666666667,Lorenzo Sonego,Diego Schwartzman,Lorenzo Sonego,Roland Garros
10,1,11,90.9090909090909,3,0,3,100.0,Dominic Thiem,Dominic Thiem,Hugo Gaston,Roland Garros
3,0,3,100.0,3,0,3,100.0,Hugo Gaston,Dominic Thiem,Hugo Gaston,Roland Garros
6,3,9,66.66666666666667,6,2,8,75.0,Jannik Sinner,Jannik Sinner,Alexander Zverev,Roland Garros
9,2,11,81.81818181818181,3,0,3,100.0,Alexander Zverev,Jannik Sinner,Alexander Zverev,Roland Garros
5,1,6,83.33333333333333,5,1,6,83.33333333333333,Rafael Nadal,Rafael Nadal,Sebastian Korda,Roland Garros
3,2,5,60.0,3,0,3,100.0,Sebastian Korda,Rafael Nadal,Sebastian Korda,Roland Garros
17,1,18,94.44444444444444,9,0,9,100.0,Novak Djokovic,Novak Djokovic,Pablo Carreno Busta,Roland Garros
10,3,13,76.92307692307692,4,1,5,80.0,Pablo Carreno Busta,Novak Djokovic,Pablo Carreno Busta,Roland Garros
13,4,17,76.47058823529412,8,2,10,80.0,Stefanos Tsitsipas,Stefanos Tsitsipas,Andrey Rublev,Roland Garros
14,3,17,82.3529411764706,10,1,11,90.9090909090909,Andrey Rublev,Stefanos Tsitsipas,Andrey Rublev,Roland Garros
10,4,14,71.42857142857143,9,2,11,81.81818181818181,Diego Schwartzman,Diego Schwartzman,Dominic Thiem,Roland Garros
11,1,12,91.66666666666667,4,0,4,100.0,Dominic Thiem,Diego Schwartzman,Dominic Thiem,Roland Garros
6,1,7,85.71428571428571,6,1,7,85.71428571428571,Rafael Nadal,Rafael Nadal,Jannik Sinner,Roland Garros
7,3,10,70.0,7,2,9,77.77777777777777,Jannik Sinner,Rafael Nadal,Jannik Sinner,Roland Garros
18,1,19,94.73684210526316,10,0,10,100.0,Novak Djokovic,Novak Djokovic,Stefanos Tsitsipas,Roland Garros
14,4,18,77.77777777777777,9,2,11,81.81818181818181,Stefanos Tsitsipas,Novak Djokovic,Stefanos Tsitsipas,Roland Garros
7,1,8,87.5,7,1,8,87.5,Rafael Nadal,Rafael Nadal,Diego Schwartzman,Roland Garros
11,4,15,73.33333333333333,10,2,12,83.33333333333333,Diego Schwartzman,Rafael Nadal,Diego Schwartzman,Roland Garros
8,1,9,88.88888888888889,8,1,9,88.88888888888889,Rafael Nadal,Rafael Nadal,Novak Djokovic,Roland Garros
19,1,20,95.0,11,0,11,100.0,Novak Djokovic,Rafael Nadal,Novak Djokovic,Roland Garros
10,4,14,71.42857142857143,5,2,7,71.42857142857143,Denis Shapovalov,Denis Shapovalov,Viktor Troicki,St Petersburg
0,0,0,,0,0,0,,Viktor Troicki,Denis Shapovalov,Viktor Troicki,St Petersburg
1,3,4,25.0,1,1,2,50.0,Gilles Simon,Gilles Simon,Marton Fucsovics,Cologne 1
7,3,10,70.0,4,2,6,66.66666666666667,Marton Fucsovics,Gilles Simon,Marton Fucsovics,Cologne 1
3,3,6,50.0,3,2,5,60.0,Laslo Djere,Laslo Djere,Sumit Nagal,Sardinia
1,1,2,50.0,0,0,0,,Sumit Nagal,Laslo Djere,Sumit Nagal,Sardinia
0,0,0,,0,0,0,,Ilya Ivashka,Ilya Ivashka,Adrian Mannarino,St Petersburg
2,5,7,28.571428571428573,2,2,4,50.0,Adrian Mannarino,Ilya Ivashka,Adrian Mannarino,St Petersburg
0,0,0,,0,0,0,,Mischa Zverev,Mischa Zverev,John Millman,Cologne 1
3,5,8,37.5,2,2,4,50.0,John Millman,Mischa Zverev,John Millman,Cologne 1
2,3,5,40.0,2,2,4,50.0,Jiri Vesely,Jiri Vesely,Kamil Majchrzak,Sardinia
0,2,2,0.0,0,1,1,0.0,Kamil Majchrzak,Jiri Vesely,Kamil Majchrzak,Sardinia
0,1,1,0.0,0,1,1,0.0,Evgeny Donskoy,Evgeny Donskoy,Egor Gerasimov,St Petersburg
1,2,3,33.333333333333336,1,1,2,50.0,Egor Gerasimov,Evgeny Donskoy,Egor Gerasimov,St Petersburg
4,5,9,44.44444444444444,1,2,3,33.333333333333336,Hubert Hurkacz,Hubert Hurkacz,Marc Polmans,Cologne 1
1,2,3,33.333333333333336,0,1,1,0.0,Marc Polmans,Hubert Hurkacz,Marc Polmans,Cologne 1
4,5,9,44.44444444444444,4,3,7,57.142857142857146,Lorenzo Sonego,Lorenzo Sonego,Giulio Zeppieri,Sardinia
0,0,0,,0,0,0,,Giulio Zeppieri,Lorenzo Sonego,Giulio Zeppieri,Sardinia
2,2,4,50.0,0,0,0,,Stan Wawrinka,Stan Wawrinka,Daniel Evans,St Petersburg
2,5,7,28.571428571428573,2,2,4,50.0,Daniel Evans,Stan Wawrinka,Daniel Evans,St Petersburg
14,4,18,77.77777777777777,4,2,6,66.66666666666667,Andrey Rublev,Andrey Rublev,Vasek Pospisil,St Petersburg
3,2,5,60.0,3,1,4,75.0,Vasek Pospisil,Andrey Rublev,Vasek Pospisil,St Petersburg
0,1,1,0.0,0,0,0,,Henri Laaksonen,Henri Laaksonen,Daniel Altmaier,Cologne 1
3,1,4,75.0,0,0,0,,Daniel Altmaier,Henri Laaksonen,Daniel Altmaier,Cologne 1
5,2,7,71.42857142857143,5,2,7,71.42857142857143,Yannick Hanfmann,Yannick Hanfmann,Salvatore Caruso,Sardinia
3,4,7,42.857142857142854,1,2,3,33.333333333333336,Salvatore Caruso,Yannick Hanfmann,Salvatore Caruso,Sardinia
5,5,10,50.0,1,2,3,33.333333333333336,Ugo Humbert,Ugo Humbert,Pavel Kotov,St Petersburg
0,0,0,,0,0,0,,Pavel Kotov,Ugo Humbert,Pavel Kotov,St Petersburg
1,3,4,25.0,0,1,1,0.0,Radu Albot,Radu Albot,Pierre Hugues Herbert,Cologne 1
1,2,3,33.333333333333336,0,0,0,,Pierre Hugues Herbert,Radu Albot,Pierre Hugues Herbert,Cologne 1
0,0,0,,0,0,0,,Andrea Pellegrino,Andrea Pellegrino,Stefano Travaglia,Sardinia
4,3,7,57.142857142857146,4,2,6,66.66666666666667,Stefano Travaglia,Andrea Pellegrino,Stefano Travaglia,Sardinia
6,3,9,66.66666666666667,1,1,2,50.0,Miomir Kecmanovic,Miomir Kecmanovic,Mikhail Kukushkin,St Petersburg
3,2,5,60.0,2,1,3,66.66666666666667,Mikhail Kukushkin,Miomir Kecmanovic,Mikhail Kukushkin,St Petersburg
0,0,0,,0,0,0,,Oscar Otte,Oscar Otte,Jan Lennard Struff,Cologne 1
6,5,11,54.54545454545455,5,2,7,71.42857142857143,Jan Lennard Struff,Oscar Otte,Jan Lennard Struff,Cologne 1
2,1,3,66.66666666666667,2,1,3,66.66666666666667,Lorenzo Musetti,Lorenzo Musetti,Pablo Cuevas,Sardinia
2,3,5,40.0,2,2,4,50.0,Pablo Cuevas,Lorenzo Musetti,Pablo Cuevas,Sardinia
2,3,5,40.0,2,2,4,50.0,Cameron Norrie,Cameron Norrie,Taylor Fritz,St Petersburg
5,5,10,50.0,3,2,5,60.0,Taylor Fritz,Cameron Norrie,Taylor Fritz,St Petersburg
4,4,8,50.0,2,2,4,50.0,Marin Cilic,Marin Cilic,Marcos Giron,Cologne 1
3,3,6,50.0,2,2,4,50.0,Marcos Giron,Marin Cilic,Marcos Giron,Cologne 1
2,4,6,33.333333333333336,2,2,4,50.0,Tommy Paul,Tommy Paul,Andrej Martin,Sardinia
1,2,3,33.333333333333336,1,1,2,50.0,Andrej Martin,Tommy Paul,Andrej Martin,Sardinia
7,3,10,70.0,6,2,8,75.0,Milos Raonic,Milos Raonic,J.J. Wolf,St Petersburg
2,2,4,50.0,2,2,4,50.0,J.J. Wolf,Milos Raonic,J.J. Wolf,St Petersburg
4,3,7,57.142857142857146,3,1,4,75.0,Alejandro Davidovich Fokina,Alejandro Davidovich Fokina,Emil Ruusuvuori,Cologne 1
2,4,6,33.333333333333336,2,2,4,50.0,Emil Ruusuvuori,Alejandro Davidovich Fokina,Emil Ruusuvuori,Cologne 1
3,3,6,50.0,3,2,5,60.0,Marco Cecchinato,Marco Cecchinato,Gianluca Mager,Sardinia
0,3,3,0.0,0,2,2,0.0,Gianluca Mager,Marco Cecchinato,Gianluca Mager,Sardinia
3,6,9,33.333333333333336,0,2,2,0.0,Alexander Bublik,Alexander Bublik,Mackenzie McDonald,St Petersburg
1,3,4,25.0,0,2,2,0.0,Mackenzie McDonald,Alexander Bublik,Mackenzie McDonald,St Petersburg
0,3,3,0.0,0,1,1,0.0,Dennis Novak,Dennis Novak,Jordan Thompson,Cologne 1
4,3,7,57.142857142857146,3,1,4,75.0,Jordan Thompson,Dennis Novak,Jordan Thompson,Cologne 1
2,2,4,50.0,0,1,1,0.0,Corentin Moutet,Corentin Moutet,Frances Tiafoe,Sardinia
3,3,6,50.0,0,1,1,0.0,Frances Tiafoe,Corentin Moutet,Frances Tiafoe,Sardinia
0,0,0,,0,0,0,,Aslan Karatsev,Aslan Karatsev,Tennys Sandgren,St Petersburg
3,5,8,37.5,2,2,4,50.0,Tennys Sandgren,Aslan Karatsev,Tennys Sandgren,St Petersburg
8,5,13,61.53846153846154,4,2,6,66.66666666666667,Karen Khachanov,Karen Khachanov,James Duckworth,St Petersburg
0,2,2,0.0,0,1,1,0.0,James Duckworth,Karen Khachanov,James Duckworth,St Petersburg
1,2,3,33.333333333333336,1,1,2,50.0,Steve Johnson,Steve Johnson,Filip Krajinovic,Cologne 1
7,4,11,63.63636363636363,5,2,7,71.42857142857143,Filip Krajinovic,Steve Johnson,Filip Krajinovic,Cologne 1
0,2,2,0.0,0,1,1,0.0,Pablo Andujar,Pablo Andujar,Jozef Kovalik,Sardinia
0,1,1,0.0,0,0,0,,Jozef Kovalik,Pablo Andujar,Jozef Kovalik,Sardinia
6,4,10,60.0,5,2,7,71.42857142857143,Borna Coric,Borna Coric,Feliciano Lopez,St Petersburg
2,3,5,40.0,0,1,1,0.0,Feliciano Lopez,Borna Coric,Feliciano Lopez,St Petersburg
2,3,5,40.0,1,2,3,33.333333333333336,Lloyd Harris,Lloyd Harris,Kyle Edmund,Cologne 1
1,3,4,25.0,1,2,3,33.333333333333336,Kyle Edmund,Lloyd Harris,Kyle Edmund,Cologne 1
2,3,5,40.0,2,2,4,50.0,Federico Delbonis,Federico Delbonis,Andreas Seppi,Sardinia
0,2,2,0.0,0,1,1,0.0,Andreas Seppi,Federico Delbonis,Andreas Seppi,Sardinia
0,0,0,,0,0,0,,Roman Safiullin,Roman Safiullin,Emilio Gomez,St Petersburg
0,1,1,0.0,0,0,0,,Emilio Gomez,Roman Safiullin,Emilio Gomez,St Petersburg
0,0,0,,0,0,0,,Fernando Verdasco,Fernando Verdasco,Andy Murray,Cologne 1
3,3,6,50.0,3,2,5,60.0,Andy Murray,Fernando Verdasco,Andy Murray,Cologne 1
3,2,5,60.0,2,1,3,66.66666666666667,Roberto Carballes Baena,Roberto Carballes Baena,Federico Coria,Sardinia
4,3,7,57.142857142857146,3,2,5,60.0,Federico Coria,Roberto Carballes Baena,Federico Coria,Sardinia
3,3,6,50.0,3,2,5,60.0,Reilly Opelka,Reilly Opelka,Nino Serdarusic,St Petersburg
0,0,0,,0,0,0,,Nino Serdarusic,Reilly Opelka,Nino Serdarusic,St Petersburg
7,4,11,63.63636363636363,7,2,9,77.77777777777777,Daniil Medvedev,Daniil Medvedev,Richard Gasquet,St Petersburg
2,3,5,40.0,2,2,4,50.0,Richard Gasquet,Daniil Medvedev,Richard Gasquet,St Petersburg
9,4,13,69.23076923076923,5,2,7,71.42857142857143,Roberto Bautista Agut,Roberto Bautista Agut,Gilles Simon,Cologne 1
2,3,5,40.0,2,1,3,66.66666666666667,Gilles Simon,Roberto Bautista Agut,Gilles Simon,Cologne 1
4,3,7,57.142857142857146,4,2,6,66.66666666666667,Laslo Djere,Laslo Djere,Dusan Lajovic,Sardinia
5,6,11,45.45454545454545,5,4,9,55.55555555555556,Dusan Lajovic,Laslo Djere,Dusan Lajovic,Sardinia
11,4,15,73.33333333333333,6,2,8,75.0,Denis Shapovalov,Denis Shapovalov,Ilya Ivashka,St Petersburg
1,0,1,100.0,1,0,1,100.0,Ilya Ivashka,Denis Shapovalov,Ilya Ivashka,St Petersburg
5,5,10,50.0,2,2,4,50.0,Hubert Hurkacz,Hubert Hurkacz,Mischa Zverev,Cologne 1
1,0,1,100.0,1,0,1,100.0,Mischa Zverev,Hubert Hurkacz,Mischa Zverev,Cologne 1
3,3,6,50.0,3,2,5,60.0,Jiri Vesely,Jiri Vesely,Lorenzo Sonego,Sardinia
5,5,10,50.0,5,3,8,62.5,Lorenzo Sonego,Jiri Vesely,Lorenzo Sonego,Sardinia
3,2,5,60.0,1,0,1,100.0,Stan Wawrinka,Stan Wawrinka,Evgeny Donskoy,St Petersburg
1,1,2,50.0,1,1,2,50.0,Evgeny Donskoy,Stan Wawrinka,Evgeny Donskoy,St Petersburg
5,5,10,50.0,4,2,6,66.66666666666667,Felix Auger Aliassime,Felix Auger Aliassime,Henri Laaksonen,Cologne 1
1,1,2,50.0,1,0,1,100.0,Henri Laaksonen,Felix Auger Aliassime,Henri Laaksonen,Cologne 1
6,2,8,75.0,6,2,8,75.0,Yannick Hanfmann,Yannick Hanfmann,Casper Ruud,Sardinia
11,5,16,68.75,9,3,12,75.0,Casper Ruud,Yannick Hanfmann,Casper Ruud,Sardinia
15,4,19,78.94736842105263,5,2,7,71.42857142857143,Andrey Rublev,Andrey Rublev,Ugo Humbert,St Petersburg
6,5,11,54.54545454545455,2,2,4,50.0,Ugo Humbert,Andrey Rublev,Ugo Humbert,St Petersburg
2,3,5,40.0,1,1,2,50.0,Radu Albot,Radu Albot,Oscar Otte,Cologne 1
1,0,1,100.0,1,0,1,100.0,Oscar Otte,Radu Albot,Oscar Otte,Cologne 1
3,1,4,75.0,3,1,4,75.0,Lorenzo Musetti,Lorenzo Musetti,Andrea Pellegrino,Sardinia
1,0,1,100.0,1,0,1,100.0,Andrea Pellegrino,Lorenzo Musetti,Andrea Pellegrino,Sardinia
3,3,6,50.0,3,2,5,60.0,Cameron Norrie,Cameron Norrie,Miomir Kecmanovic,St Petersburg
7,3,10,70.0,2,1,3,66.66666666666667,Miomir Kecmanovic,Cameron Norrie,Miomir Kecmanovic,St Petersburg
5,3,8,62.5,4,1,5,80.0,Alejandro Davidovich Fokina,Alejandro Davidovich Fokina,Marin Cilic,Cologne 1
5,4,9,55.55555555555556,3,2,5,60.0,Marin Cilic,Alejandro Davidovich Fokina,Marin Cilic,Cologne 1
4,3,7,57.142857142857146,4,2,6,66.66666666666667,Marco Cecchinato,Marco Cecchinato,Tommy Paul,Sardinia
3,4,7,42.857142857142854,3,2,5,60.0,Tommy Paul,Marco Cecchinato,Tommy Paul,Sardinia
8,3,11,72.72727272727273,7,2,9,77.77777777777777,Milos Raonic,Milos Raonic,Alexander Bublik,St Petersburg
4,6,10,40.0,1,2,3,33.333333333333336,Alexander Bublik,Milos Raonic,Alexander Bublik,St Petersburg
1,3,4,25.0,1,1,2,50.0,Dennis Novak,Dennis Novak,Benoit Paire,Cologne 1
1,4,5,20.0,0,1,1,0.0,Benoit Paire,Dennis Novak,Benoit Paire,Cologne 1
1,5,6,16.666666666666668,1,4,5,20.0,Albert Ramos,Albert Ramos,Corentin Moutet,Sardinia
3,2,5,60.0,1,1,2,50.0,Corentin Moutet,Albert Ramos,Corentin Moutet,Sardinia
9,5,14,64.28571428571429,5,2,7,71.42857142857143,Karen Khachanov,Karen Khachanov,Aslan Karatsev,St Petersburg
1,0,1,100.0,1,0,1,100.0,Aslan Karatsev,Karen Khachanov,Aslan Karatsev,St Petersburg
3,3,6,50.0,2,2,4,50.0,Lloyd Harris,Lloyd Harris,Steve Johnson,Cologne 1
2,2,4,50.0,2,1,3,66.66666666666667,Steve Johnson,Lloyd Harris,Steve Johnson,Cologne 1
3,3,6,50.0,3,2,5,60.0,Federico Delbonis,Federico Delbonis,Pablo Andujar,Sardinia
1,2,3,33.333333333333336,1,1,2,50.0,Pablo Andujar,Federico Delbonis,Pablo Andujar,Sardinia
7,4,11,63.63636363636363,6,2,8,75.0,Borna Coric,Borna Coric,Roman Safiullin,St Petersburg
1,0,1,100.0,1,0,1,100.0,Roman Safiullin,Borna Coric,Roman Safiullin,St Petersburg
9,3,12,75.0,6,2,8,75.0,Alexander Zverev,Alexander Zverev,Fernando Verdasco,Cologne 1
1,0,1,100.0,1,0,1,100.0,Fernando Verdasco,Alexander Zverev,Fernando Verdasco,Cologne 1
0,0,0,,0,0,0,,Danilo Petrovic,Danilo Petrovic,Roberto Carballes Baena,Sardinia
4,2,6,66.66666666666667,3,1,4,75.0,Roberto Carballes Baena,Danilo Petrovic,Roberto Carballes Baena,Sardinia
4,3,7,57.142857142857146,4,2,6,66.66666666666667,Reilly Opelka,Reilly Opelka,Daniil Medvedev,St Petersburg
8,4,12,66.66666666666667,8,2,10,80.0,Daniil Medvedev,Reilly Opelka,Daniil Medvedev,St Petersburg
10,4,14,71.42857142857143,6,2,8,75.0,Roberto Bautista Agut,Roberto Bautista Agut,Hubert Hurkacz,Cologne 1
6,5,11,54.54545454545455,3,2,5,60.0,Hubert Hurkacz,Roberto Bautista Agut,Hubert Hurkacz,Cologne 1
5,3,8,62.5,5,2,7,71.42857142857143,Laslo Djere,Laslo Djere,Jiri Vesely,Sardinia
4,3,7,57.142857142857146,4,2,6,66.66666666666667,Jiri Vesely,Laslo Djere,Jiri Vesely,Sardinia
12,4,16,75.0,7,2,9,77.77777777777777,Denis Shapovalov,Denis Shapovalov,Stan Wawrinka,St Petersburg
4,2,6,66.66666666666667,2,0,2,100.0,Stan Wawrinka,Denis Shapovalov,Stan Wawrinka,St Petersburg
6,5,11,54.54545454545455,5,2,7,71.42857142857143,Felix Auger Aliassime,Felix Auger Aliassime,Radu Albot,Cologne 1
3,3,6,50.0,2,1,3,66.66666666666667,Radu Albot,Felix Auger Aliassime,Radu Albot,Cologne 1
4,1,5,80.0,4,1,5,80.0,Lorenzo Musetti,Lorenzo Musetti,Yannick Hanfmann,Sardinia
7,2,9,77.77777777777777,7,2,9,77.77777777777777,Yannick Hanfmann,Lorenzo Musetti,Yannick Hanfmann,Sardinia
16,4,20,80.0,6,2,8,75.0,Andrey Rublev,Andrey Rublev,Cameron Norrie,St Petersburg
4,3,7,57.142857142857146,4,2,6,66.66666666666667,Cameron Norrie,Andrey Rublev,Cameron Norrie,St Petersburg
6,3,9,66.66666666666667,5,1,6,83.33333333333333,Alejandro Davidovich Fokina,Alejandro Davidovich Fokina,Dennis Novak,Cologne 1
2,3,5,40.0,2,1,3,66.66666666666667,Dennis Novak,Alejandro Davidovich Fokina,Dennis Novak,Cologne 1
5,3,8,62.5,5,2,7,71.42857142857143,Marco Cecchinato,Marco Cecchinato,Albert Ramos,Sardinia
2,5,7,28.571428571428573,2,4,6,33.333333333333336,Albert Ramos,Marco Cecchinato,Albert Ramos,Sardinia
9,3,12,75.0,8,2,10,80.0,Milos Raonic,Milos Raonic,Karen Khachanov,St Petersburg
10,5,15,66.66666666666667,6,2,8,75.0,Karen Khachanov,Milos Raonic,Karen Khachanov,St Petersburg
10,3,13,76.92307692307692,7,2,9,77.77777777777777,Alexander Zverev,Alexander Zverev,Lloyd Harris,Cologne 1
4,3,7,57.142857142857146,3,2,5,60.0,Lloyd Harris,Alexander Zverev,Lloyd Harris,Cologne 1
1,0,1,100.0,1,0,1,100.0,Danilo Petrovic,Danilo Petrovic,Federico Delbonis,Sardinia
4,3,7,57.142857142857146,4,2,6,66.66666666666667,Federico Delbonis,Danilo Petrovic,Federico Delbonis,Sardinia
8,4,12,66.66666666666667,7,2,9,77.77777777777777,Borna Coric,Borna Coric,Reilly Opelka,St Petersburg
5,3,8,62.5,5,2,7,71.42857142857143,Reilly Opelka,Borna Coric,Reilly Opelka,St Petersburg
7,5,12,58.333333333333336,6,2,8,75.0,Felix Auger Aliassime,Felix Auger Aliassime,Roberto Bautista Agut,Cologne 1
11,4,15,73.33333333333333,7,2,9,77.77777777777777,Roberto Bautista Agut,Felix Auger Aliassime,Roberto Bautista Agut,Cologne 1
6,3,9,66.66666666666667,6,2,8,75.0,Laslo Djere,Laslo Djere,Lorenzo Musetti,Sardinia
5,1,6,83.33333333333333,5,1,6,83.33333333333333,Lorenzo Musetti,Laslo Djere,Lorenzo Musetti,Sardinia
17,4,21,80.95238095238095,7,2,9,77.77777777777777,Andrey Rublev,Andrey Rublev,Denis Shapovalov,St Petersburg
13,4,17,76.47058823529412,8,2,10,80.0,Denis Shapovalov,Andrey Rublev,Denis Shapovalov,St Petersburg
11,3,14,78.57142857142857,8,2,10,80.0,Alexander Zverev,Alexander Zverev,Alejandro Davidovich Fokina,Cologne 1
7,3,10,70.0,6,1,7,85.71428571428571,Alejandro Davidovich Fokina,Alexander Zverev,Alejandro Davidovich Fokina,Cologne 1
6,3,9,66.66666666666667,6,2,8,75.0,Marco Cecchinato,Marco Cecchinato,Danilo Petrovic,Sardinia
2,0,2,100.0,2,0,2,100.0,Danilo Petrovic,Marco Cecchinato,Danilo Petrovic,Sardinia
9,4,13,69.23076923076923,8,2,10,80.0,Borna Coric,Borna Coric,Milos Raonic,St Petersburg
10,3,13,76.92307692307692,9,2,11,81.81818181818181,Milos Raonic,Borna Coric,Milos Raonic,St Petersburg
12,3,15,80.0,9,2,11,81.81818181818181,Alexander Zverev,Alexander Zverev,Felix Auger Aliassime,Cologne 1
8,5,13,61.53846153846154,7,2,9,77.77777777777777,Felix Auger Aliassime,Alexander Zverev,Felix Auger Aliassime,Cologne 1
7,3,10,70.0,7,2,9,77.77777777777777,Laslo Djere,Laslo Djere,Marco Cecchinato,Sardinia
7,3,10,70.0,7,2,9,77.77777777777777,Marco Cecchinato,Laslo Djere,Marco Cecchinato,Sardinia
18,4,22,81.81818181818181,8,2,10,80.0,Andrey Rublev,Andrey Rublev,Borna Coric,St Petersburg
10,4,14,71.42857142857143,9,2,11,81.81818181818181,Borna Coric,Andrey Rublev,Borna Coric,St Petersburg
6,6,12,50.0,2,3,5,40.0,Ugo Humbert,Ugo Humbert,Alex De Minaur,Antwerp
4,4,8,50.0,4,2,6,66.66666666666667,Alex De Minaur,Ugo Humbert,Alex De Minaur,Antwerp
4,5,9,44.44444444444444,4,3,7,57.142857142857146,Alex De Minaur,Alex De Minaur,Grigor Dimitrov,Antwerp
8,4,12,66.66666666666667,2,2,4,50.0,Grigor Dimitrov,Alex De Minaur,Grigor Dimitrov,Antwerp
7,6,13,53.84615384615385,3,3,6,50.0,Ugo Humbert,Ugo Humbert,Daniel Evans,Antwerp
2,6,8,25.0,2,3,5,40.0,Daniel Evans,Ugo Humbert,Daniel Evans,Antwerp
5,5,10,50.0,5,3,8,62.5,Alex De Minaur,Alex De Minaur,Marcos Giron,Antwerp
3,4,7,42.857142857142854,2,3,5,40.0,Marcos Giron,Alex De Minaur,Marcos Giron,Antwerp
8,5,13,61.53846153846154,2,3,5,40.0,Grigor Dimitrov,Grigor Dimitrov,Milos Raonic,Antwerp
10,4,14,71.42857142857143,9,3,12,75.0,Milos Raonic,Grigor Dimitrov,Milos Raonic,Antwerp
2,7,9,22.22222222222222,2,4,6,33.333333333333336,Daniel Evans,Daniel Evans,Karen Khachanov,Antwerp
10,6,16,62.5,6,3,9,66.66666666666667,Karen Khachanov,Daniel Evans,Karen Khachanov,Antwerp
8,6,14,57.142857142857146,4,3,7,57.142857142857146,Ugo Humbert,Ugo Humbert,Lloyd Harris,Antwerp
4,4,8,50.0,3,3,6,50.0,Lloyd Harris,Ugo Humbert,Lloyd Harris,Antwerp
3,5,8,37.5,2,4,6,33.333333333333336,Marcos Giron,Marcos Giron,David Goffin,Antwerp
4,4,8,50.0,4,2,6,66.66666666666667,David Goffin,Marcos Giron,David Goffin,Antwerp
6,5,11,54.54545454545455,6,3,9,66.66666666666667,Alex De Minaur,Alex De Minaur,Feliciano Lopez,Antwerp
2,4,6,33.333333333333336,0,2,2,0.0,Feliciano Lopez,Alex De Minaur,Feliciano Lopez,Antwerp
9,5,14,64.28571428571429,3,3,6,50.0,Grigor Dimitrov,Grigor Dimitrov,Pablo Andujar,Antwerp
1,3,4,25.0,0,1,1,0.0,Pablo Andujar,Grigor Dimitrov,Pablo Andujar,Antwerp
10,5,15,66.66666666666667,9,4,13,69.23076923076923,Milos Raonic,Milos Raonic,Cameron Norrie,Antwerp
4,4,8,50.0,4,3,7,57.142857142857146,Cameron Norrie,Milos Raonic,Cameron Norrie,Antwerp
3,7,10,30.0,3,4,7,42.857142857142854,Daniel Evans,Daniel Evans,Frances Tiafoe,Antwerp
3,4,7,42.857142857142854,3,2,5,60.0,Frances Tiafoe,Daniel Evans,Frances Tiafoe,Antwerp
10,7,17,58.8235294117647,6,4,10,60.0,Karen Khachanov,Karen Khachanov,Zizou Bergs,Antwerp
0,0,0,,0,0,0,,Zizou Bergs,Karen Khachanov,Zizou Bergs,Antwerp
4,5,9,44.44444444444444,3,4,7,42.857142857142854,Lloyd Harris,Lloyd Harris,Taylor Fritz,Antwerp
5,6,11,45.45454545454545,3,3,6,50.0,Taylor Fritz,Lloyd Harris,Taylor Fritz,Antwerp
9,6,15,60.0,5,3,8,62.5,Ugo Humbert,Ugo Humbert,Pablo Carreno Busta,Antwerp
10,4,14,71.42857142857143,6,2,8,75.0,Pablo Carreno Busta,Ugo Humbert,Pablo Carreno Busta,Antwerp
4,5,9,44.44444444444444,3,4,7,42.857142857142854,Marcos Giron,Marcos Giron,Luca Nardi,Antwerp
0,0,0,,0,0,0,,Luca Nardi,Marcos Giron,Luca Nardi,Antwerp
2,5,7,28.571428571428573,0,3,3,0.0,Feliciano Lopez,Feliciano Lopez,Tommy Paul,Antwerp
3,5,8,37.5,0,2,2,0.0,Tommy Paul,Feliciano Lopez,Tommy Paul,Antwerp
7,5,12,58.333333333333336,7,3,10,70.0,Alex De Minaur,Alex De Minaur,Richard Gasquet,Antwerp
2,4,6,33.333333333333336,2,3,5,40.0,Richard Gasquet,Alex De Minaur,Richard Gasquet,Antwerp
1,4,5,20.0,0,2,2,0.0,Pablo Andujar,Pablo Andujar,Federico Coria,Antwerp
4,4,8,50.0,1,1,2,50.0,Federico Coria,Pablo Andujar,Federico Coria,Antwerp
4,5,9,44.44444444444444,4,4,8,50.0,Cameron Norrie,Cameron Norrie,Emil Ruusuvuori,Antwerp
2,5,7,28.571428571428573,2,3,5,40.0,Emil Ruusuvuori,Cameron Norrie,Emil Ruusuvuori,Antwerp
11,5,16,68.75,10,4,14,71.42857142857143,Milos Raonic,Milos Raonic,Aljaz Bedene,Antwerp
4,3,7,57.142857142857146,2,2,4,50.0,Aljaz Bedene,Milos Raonic,Aljaz Bedene,Antwerp
3,5,8,37.5,3,3,6,50.0,Frances Tiafoe,Frances Tiafoe,Dusan Lajovic,Antwerp
5,7,12,41.666666666666664,0,2,2,0.0,Dusan Lajovic,Frances Tiafoe,Dusan Lajovic,Antwerp
4,7,11,36.36363636363637,4,4,8,50.0,Daniel Evans,Daniel Evans,Salvatore Caruso,Antwerp
3,5,8,37.5,2,2,4,50.0,Salvatore Caruso,Daniel Evans,Salvatore Caruso,Antwerp
0,1,1,0.0,0,1,1,0.0,Zizou Bergs,Zizou Bergs,Albert Ramos,Antwerp
2,6,8,25.0,0,1,1,0.0,Albert Ramos,Zizou Bergs,Albert Ramos,Antwerp
5,7,12,41.666666666666664,3,4,7,42.857142857142854,Taylor Fritz,Taylor Fritz,Reilly Opelka,Antwerp
5,4,9,55.55555555555556,5,3,8,62.5,Reilly Opelka,Taylor Fritz,Reilly Opelka,Antwerp
5,5,10,50.0,4,4,8,50.0,Lloyd Harris,Lloyd Harris,Corentin Moutet,Antwerp
3,3,6,50.0,2,1,3,66.66666666666667,Corentin Moutet,Lloyd Harris,Corentin Moutet,Antwerp
10,6,16,62.5,6,3,9,66.66666666666667,Ugo Humbert,Ugo Humbert,Kimmer Coppejans,Antwerp
0,0,0,,0,0,0,,Kimmer Coppejans,Ugo Humbert,Kimmer Coppejans,Antwerp
1,1,2,50.0,1,1,2,50.0,Oscar Otte,Oscar Otte,Dennis Novak,Cologne 2
2,4,6,33.333333333333336,2,2,4,50.0,Dennis Novak,Oscar Otte,Dennis Novak,Cologne 2
7,4,11,63.63636363636363,6,2,8,75.0,Alejandro Davidovich Fokina,Alejandro Davidovich Fokina,Damir Dzumhur,Cologne 2
0,1,1,0.0,0,1,1,0.0,Damir Dzumhur,Alejandro Davidovich Fokina,Damir Dzumhur,Cologne 2
2,3,5,40.0,2,2,4,50.0,Steve Johnson,Steve Johnson,Marin Cilic,Cologne 2
5,5,10,50.0,3,3,6,50.0,Marin Cilic,Steve Johnson,Marin Cilic,Cologne 2
1,3,4,25.0,1,2,3,33.333333333333336,Egor Gerasimov,Egor Gerasimov,Daniel Altmaier,Cologne 2
3,2,5,60.0,0,1,1,0.0,Daniel Altmaier,Egor Gerasimov,Daniel Altmaier,Cologne 2
2,5,7,28.571428571428573,0,1,1,0.0,Yoshihito Nishioka,Yoshihito Nishioka,Kyle Edmund,Cologne 2
1,4,5,20.0,1,3,4,25.0,Kyle Edmund,Yoshihito Nishioka,Kyle Edmund,Cologne 2
6,6,12,50.0,5,3,8,62.5,Jan Lennard Struff,Jan Lennard Struff,Marco Cecchinato,Cologne 2
7,4,11,63.63636363636363,0,1,1,0.0,Marco Cecchinato,Jan Lennard Struff,Marco Cecchinato,Cologne 2
7,4,11,63.63636363636363,0,1,1,0.0,Jannik Sinner,Jannik Sinner,James Duckworth,Cologne 2
0,3,3,0.0,0,2,2,0.0,James Duckworth,Jannik Sinner,James Duckworth,Cologne 2
1,3,4,25.0,0,1,1,0.0,Pierre Hugues Herbert,Pierre Hugues Herbert,Tennys Sandgren,Cologne 2
3,6,9,33.333333333333336,2,3,5,40.0,Tennys Sandgren,Pierre Hugues Herbert,Tennys Sandgren,Cologne 2
2,4,6,33.333333333333336,2,2,4,50.0,Gilles Simon,Gilles Simon,Jordan Thompson,Cologne 2
4,4,8,50.0,3,2,5,60.0,Jordan Thompson,Gilles Simon,Jordan Thompson,Cologne 2
2,6,8,25.0,2,3,5,40.0,Adrian Mannarino,Adrian Mannarino,Alexei Popyrin,Cologne 2
0,1,1,0.0,0,0,0,,Alexei Popyrin,Adrian Mannarino,Alexei Popyrin,Cologne 2
7,4,11,63.63636363636363,2,2,4,50.0,Miomir Kecmanovic,Miomir Kecmanovic,Sumit Nagal,Cologne 2
1,2,3,33.333333333333336,1,1,2,50.0,Sumit Nagal,Miomir Kecmanovic,Sumit Nagal,Cologne 2
3,6,9,33.333333333333336,2,3,5,40.0,John Millman,John Millman,Fernando Verdasco,Cologne 2
1,1,2,50.0,1,1,2,50.0,Fernando Verdasco,John Millman,Fernando Verdasco,Cologne 2
11,5,16,68.75,1,2,3,33.333333333333336,Diego Schwartzman,Diego Schwartzman,Oscar Otte,Cologne 2
2,1,3,66.66666666666667,2,1,3,66.66666666666667,Oscar Otte,Diego Schwartzman,Oscar Otte,Cologne 2
8,4,12,66.66666666666667,7,2,9,77.77777777777777,Alejandro Davidovich Fokina,Alejandro Davidovich Fokina,Steve Johnson,Cologne 2
3,3,6,50.0,3,2,5,60.0,Steve Johnson,Alejandro Davidovich Fokina,Steve Johnson,Cologne 2
8,6,14,57.142857142857146,7,3,10,70.0,Felix Auger Aliassime,Felix Auger Aliassime,Egor Gerasimov,Cologne 2
2,3,5,40.0,2,2,4,50.0,Egor Gerasimov,Felix Auger Aliassime,Egor Gerasimov,Cologne 2
3,5,8,37.5,1,1,2,50.0,Yoshihito Nishioka,Yoshihito Nishioka,Jan Lennard Struff,Cologne 2
7,6,13,53.84615384615385,6,3,9,66.66666666666667,Jan Lennard Struff,Yoshihito Nishioka,Jan Lennard Struff,Cologne 2
8,4,12,66.66666666666667,1,1,2,50.0,Jannik Sinner,Jannik Sinner,Pierre Hugues Herbert,Cologne 2
2,3,5,40.0,1,1,2,50.0,Pierre Hugues Herbert,Jannik Sinner,Pierre Hugues Herbert,Cologne 2
3,4,7,42.857142857142854,3,2,5,60.0,Gilles Simon,Gilles Simon,Denis Shapovalov,Cologne 2
13,5,18,72.22222222222223,8,3,11,72.72727272727273,Denis Shapovalov,Gilles Simon,Denis Shapovalov,Cologne 2
3,6,9,33.333333333333336,3,3,6,50.0,Adrian Mannarino,Adrian Mannarino,Miomir Kecmanovic,Cologne 2
8,4,12,66.66666666666667,3,2,5,60.0,Miomir Kecmanovic,Adrian Mannarino,Miomir Kecmanovic,Cologne 2
13,3,16,81.25,10,2,12,83.33333333333333,Alexander Zverev,Alexander Zverev,John Millman,Cologne 2
4,6,10,40.0,3,3,6,50.0,John Millman,Alexander Zverev,John Millman,Cologne 2
12,5,17,70.58823529411765,2,2,4,50.0,Diego Schwartzman,Diego Schwartzman,Alejandro Davidovich Fokina,Cologne 2
9,4,13,69.23076923076923,8,2,10,80.0,Alejandro Davidovich Fokina,Diego Schwartzman,Alejandro Davidovich Fokina,Cologne 2
9,6,15,60.0,8,3,11,72.72727272727273,Felix Auger Aliassime,Felix Auger Aliassime,Yoshihito Nishioka,Cologne 2
4,5,9,44.44444444444444,2,1,3,66.66666666666667,Yoshihito Nishioka,Felix Auger Aliassime,Yoshihito Nishioka,Cologne 2
9,4,13,69.23076923076923,2,1,3,66.66666666666667,Jannik Sinner,Jannik Sinner,Gilles Simon,Cologne 2
4,4,8,50.0,4,2,6,66.66666666666667,Gilles Simon,Jannik Sinner,Gilles Simon,Cologne 2
14,3,17,82.3529411764706,11,2,13,84.61538461538461,Alexander Zverev,Alexander Zverev,Adrian Mannarino,Cologne 2
4,6,10,40.0,4,3,7,57.142857142857146,Adrian Mannarino,Alexander Zverev,Adrian Mannarino,Cologne 2
13,5,18,72.22222222222223,3,2,5,60.0,Diego Schwartzman,Diego Schwartzman,Felix Auger Aliassime,Cologne 2
10,6,16,62.5,9,3,12,75.0,Felix Auger Aliassime,Diego Schwartzman,Felix Auger Aliassime,Cologne 2
15,3,18,83.33333333333333,12,2,14,85.71428571428571,Alexander Zverev,Alexander Zverev,Jannik Sinner,Cologne 2
10,4,14,71.42857142857143,3,1,4,75.0,Jannik Sinner,Alexander Zverev,Jannik Sinner,Cologne 2
16,3,19,84.21052631578948,13,2,15,86.66666666666667,Alexander Zverev,Alexander Zverev,Diego Schwartzman,Cologne 2
14,5,19,73.6842105263158,4,2,6,66.66666666666667,Diego Schwartzman,Alexander Zverev,Diego Schwartzman,Cologne 2
11,2,13,84.61538461538461,7,1,8,87.5,Dominic Thiem,Dominic Thiem,Vitaliy Sachko,Vienna
0,0,0,,0,0,0,,Vitaliy Sachko,Dominic Thiem,Vitaliy Sachko,Vienna
4,5,9,44.44444444444444,4,3,7,57.142857142857146,Frances Tiafoe,Frances Tiafoe,Corentin Moutet,Nur-Sultan
3,4,7,42.857142857142854,2,2,4,50.0,Corentin Moutet,Frances Tiafoe,Corentin Moutet,Nur-Sultan
6,5,11,54.54545454545455,1,2,3,33.333333333333336,Christian Garin,Christian Garin,Stan Wawrinka,Vienna
4,3,7,57.142857142857146,2,1,3,66.66666666666667,Stan Wawrinka,Christian Garin,Stan Wawrinka,Vienna
2,4,6,33.333333333333336,2,3,5,40.0,Egor Gerasimov,Egor Gerasimov,Lloyd Harris,Nur-Sultan
6,5,11,54.54545454545455,5,4,9,55.55555555555556,Lloyd Harris,Egor Gerasimov,Lloyd Harris,Nur-Sultan
10,5,15,66.66666666666667,3,2,5,60.0,Jannik Sinner,Jannik Sinner,Casper Ruud,Vienna
11,6,17,64.70588235294117,2,2,4,50.0,Casper Ruud,Jannik Sinner,Casper Ruud,Vienna
4,4,8,50.0,0,1,1,0.0,Jiri Vesely,Jiri Vesely,Tennys Sandgren,Nur-Sultan
3,7,10,30.0,2,4,6,33.333333333333336,Tennys Sandgren,Jiri Vesely,Tennys Sandgren,Nur-Sultan
19,4,23,82.6086956521739,9,2,11,81.81818181818181,Andrey Rublev,Andrey Rublev,Norbert Gombos,Vienna
3,3,6,50.0,1,2,3,33.333333333333336,Norbert Gombos,Andrey Rublev,Norbert Gombos,Vienna
8,5,13,61.53846153846154,8,3,11,72.72727272727273,Daniil Medvedev,Daniil Medvedev,Jason Jung,Vienna
0,2,2,0.0,0,1,1,0.0,Jason Jung,Daniil Medvedev,Jason Jung,Vienna
1,2,3,33.333333333333336,1,2,3,33.333333333333336,Fernando Verdasco,Fernando Verdasco,James Duckworth,Nur-Sultan
0,4,4,0.0,0,3,3,0.0,James Duckworth,Fernando Verdasco,James Duckworth,Nur-Sultan
3,3,6,50.0,3,2,5,60.0,Vasek Pospisil,Vasek Pospisil,Felix Auger Aliassime,Vienna
10,7,17,58.8235294117647,9,4,13,69.23076923076923,Felix Auger Aliassime,Vasek Pospisil,Felix Auger Aliassime,Vienna
3,4,7,42.857142857142854,2,2,4,50.0,Radu Albot,Radu Albot,Dmitry Popko,Nur-Sultan
0,0,0,,0,0,0,,Dmitry Popko,Radu Albot,Dmitry Popko,Nur-Sultan
3,5,8,37.5,1,2,3,33.333333333333336,Kevin Anderson,Kevin Anderson,Dennis Novak,Vienna
2,5,7,28.571428571428573,2,3,5,40.0,Dennis Novak,Kevin Anderson,Dennis Novak,Vienna
3,6,9,33.333333333333336,0,3,3,0.0,Tommy Paul,Tommy Paul,Stefano Travaglia,Nur-Sultan
4,4,8,50.0,0,1,1,0.0,Stefano Travaglia,Tommy Paul,Stefano Travaglia,Nur-Sultan
10,5,15,66.66666666666667,6,3,9,66.66666666666667,Pablo Carreno Busta,Pablo Carreno Busta,Gael Monfils,Vienna
0,3,3,0.0,0,0,0,,Gael Monfils,Pablo Carreno Busta,Gael Monfils,Vienna
1,4,5,20.0,0,3,3,0.0,Mackenzie McDonald,Mackenzie McDonald,Alexander Bublik,Nur-Sultan
4,7,11,36.36363636363637,1,3,4,25.0,Alexander Bublik,Mackenzie McDonald,Alexander Bublik,Nur-Sultan
1,1,2,50.0,0,0,0,,Jurij Rodionov,Jurij Rodionov,Denis Shapovalov,Vienna
13,6,19,68.42105263157895,8,4,12,66.66666666666667,Denis Shapovalov,Jurij Rodionov,Denis Shapovalov,Vienna
0,3,3,0.0,0,1,1,0.0,Andreas Seppi,Andreas Seppi,Aslan Karatsev,Nur-Sultan
1,1,2,50.0,1,1,2,50.0,Aslan Karatsev,Andreas Seppi,Aslan Karatsev,Nur-Sultan
5,7,12,41.666666666666664,5,4,9,55.55555555555556,Daniel Evans,Daniel Evans,Aljaz Bedene,Vienna
4,4,8,50.0,2,3,5,40.0,Aljaz Bedene,Daniel Evans,Aljaz Bedene,Vienna
0,2,2,0.0,0,1,1,0.0,Yuichi Sugita,Yuichi Sugita,Damir Dzumhur,Nur-Sultan
0,2,2,0.0,0,2,2,0.0,Damir Dzumhur,Yuichi Sugita,Damir Dzumhur,Nur-Sultan
10,5,15,66.66666666666667,4,3,7,57.142857142857146,Grigor Dimitrov,Grigor Dimitrov,Karen Khachanov,Vienna
11,7,18,61.111111111111114,7,4,11,63.63636363636363,Karen Khachanov,Grigor Dimitrov,Karen Khachanov,Vienna
14,5,19,73.6842105263158,5,2,7,71.42857142857143,Stefanos Tsitsipas,Stefanos Tsitsipas,Jan Lennard Struff,Vienna
7,7,14,50.0,6,4,10,60.0,Jan Lennard Struff,Stefanos Tsitsipas,Jan Lennard Struff,Vienna
4,5,9,44.44444444444444,3,3,6,50.0,Jordan Thompson,Jordan Thompson,Cameron Norrie,Nur-Sultan
5,5,10,50.0,5,4,9,55.55555555555556,Cameron Norrie,Jordan Thompson,Cameron Norrie,Nur-Sultan
5,6,11,45.45454545454545,0,2,2,0.0,Lorenzo Sonego,Lorenzo Sonego,Dusan Lajovic,Vienna
5,8,13,38.46153846153846,0,3,3,0.0,Dusan Lajovic,Lorenzo Sonego,Dusan Lajovic,Vienna
2,6,8,25.0,2,4,6,33.333333333333336,Emil Ruusuvuori,Emil Ruusuvuori,Timofey Skatov,Nur-Sultan
0,0,0,,0,0,0,,Timofey Skatov,Emil Ruusuvuori,Timofey Skatov,Nur-Sultan
6,6,12,50.0,3,3,6,50.0,Hubert Hurkacz,Hubert Hurkacz,Attila Balazs,Vienna
1,2,3,33.333333333333336,0,1,1,0.0,Attila Balazs,Hubert Hurkacz,Attila Balazs,Vienna
3,3,6,50.0,2,2,4,50.0,Mikhail Kukushkin,Mikhail Kukushkin,Federico Delbonis,Nur-Sultan
4,4,8,50.0,0,1,1,0.0,Federico Delbonis,Mikhail Kukushkin,Federico Delbonis,Nur-Sultan
10,5,15,66.66666666666667,9,3,12,75.0,Borna Coric,Borna Coric,Taylor Fritz,Vienna
6,7,13,46.15384615384615,4,4,8,50.0,Taylor Fritz,Borna Coric,Taylor Fritz,Vienna
19,2,21,90.47619047619048,8,1,9,88.88888888888889,Novak Djokovic,Novak Djokovic,Filip Krajinovic,Vienna
7,5,12,58.333333333333336,5,3,8,62.5,Filip Krajinovic,Novak Djokovic,Filip Krajinovic,Vienna
5,5,10,50.0,5,3,8,62.5,Frances Tiafoe,Frances Tiafoe,Miomir Kecmanovic,Nur-Sultan
8,5,13,61.53846153846154,3,3,6,50.0,Miomir Kecmanovic,Frances Tiafoe,Miomir Kecmanovic,Nur-Sultan
12,2,14,85.71428571428571,8,1,9,88.88888888888889,Dominic Thiem,Dominic Thiem,Christian Garin,Vienna
7,5,12,58.333333333333336,2,2,4,50.0,Christian Garin,Dominic Thiem,Christian Garin,Vienna
3,4,7,42.857142857142854,3,3,6,50.0,Egor Gerasimov,Egor Gerasimov,Jiri Vesely,Nur-Sultan
5,4,9,55.55555555555556,1,1,2,50.0,Jiri Vesely,Egor Gerasimov,Jiri Vesely,Nur-Sultan
20,4,24,83.33333333333333,10,2,12,83.33333333333333,Andrey Rublev,Andrey Rublev,Jannik Sinner,Vienna
11,5,16,68.75,4,2,6,66.66666666666667,Jannik Sinner,Andrey Rublev,Jannik Sinner,Vienna
4,7,11,36.36363636363637,3,4,7,42.857142857142854,John Millman,John Millman,Fernando Verdasco,Nur-Sultan
2,2,4,50.0,2,2,4,50.0,Fernando Verdasco,John Millman,Fernando Verdasco,Nur-Sultan
9,5,14,64.28571428571429,9,3,12,75.0,Daniil Medvedev,Daniil Medvedev,Vasek Pospisil,Vienna
4,3,7,57.142857142857146,4,2,6,66.66666666666667,Vasek Pospisil,Daniil Medvedev,Vasek Pospisil,Vienna
4,6,10,40.0,1,3,4,25.0,Tommy Paul,Tommy Paul,Radu Albot,Nur-Sultan
4,4,8,50.0,3,2,5,60.0,Radu Albot,Tommy Paul,Radu Albot,Nur-Sultan
4,5,9,44.44444444444444,2,2,4,50.0,Kevin Anderson,Kevin Anderson,Pablo Carreno Busta,Vienna
11,5,16,68.75,7,3,10,70.0,Pablo Carreno Busta,Kevin Anderson,Pablo Carreno Busta,Vienna
2,4,6,33.333333333333336,1,3,4,25.0,Mackenzie McDonald,Mackenzie McDonald,Andreas Seppi,Nur-Sultan
1,3,4,25.0,1,1,2,50.0,Andreas Seppi,Mackenzie McDonald,Andreas Seppi,Nur-Sultan
6,7,13,46.15384615384615,6,4,10,60.0,Daniel Evans,Daniel Evans,Jurij Rodionov,Vienna
2,1,3,66.66666666666667,1,0,1,100.0,Jurij Rodionov,Daniel Evans,Jurij Rodionov,Vienna
4,7,11,36.36363636363637,4,4,8,50.0,Adrian Mannarino,Adrian Mannarino,Yuichi Sugita,Nur-Sultan
1,2,3,33.333333333333336,1,1,2,50.0,Yuichi Sugita,Adrian Mannarino,Yuichi Sugita,Nur-Sultan
11,5,16,68.75,5,3,8,62.5,Grigor Dimitrov,Grigor Dimitrov,Stefanos Tsitsipas,Vienna
15,5,20,75.0,6,2,8,75.0,Stefanos Tsitsipas,Grigor Dimitrov,Stefanos Tsitsipas,Vienna
3,6,9,33.333333333333336,3,4,7,42.857142857142854,Emil Ruusuvuori,Emil Ruusuvuori,Jordan Thompson,Nur-Sultan
5,5,10,50.0,4,3,7,57.142857142857146,Jordan Thompson,Emil Ruusuvuori,Jordan Thompson,Nur-Sultan
6,6,12,50.0,1,2,3,33.333333333333336,Lorenzo Sonego,Lorenzo Sonego,Hubert Hurkacz,Vienna
7,6,13,53.84615384615385,4,3,7,57.142857142857146,Hubert Hurkacz,Lorenzo Sonego,Hubert Hurkacz,Vienna
4,3,7,57.142857142857146,3,2,5,60.0,Mikhail Kukushkin,Mikhail Kukushkin,Benoit Paire,Nur-Sultan
1,5,6,16.666666666666668,0,2,2,0.0,Benoit Paire,Mikhail Kukushkin,Benoit Paire,Nur-Sultan
20,2,22,90.9090909090909,9,1,10,90.0,Novak Djokovic,Novak Djokovic,Borna Coric,Vienna
11,5,16,68.75,10,3,13,76.92307692307692,Borna Coric,Novak Djokovic,Borna Coric,Vienna
6,5,11,54.54545454545455,6,3,9,66.66666666666667,Frances Tiafoe,Frances Tiafoe,Egor Gerasimov,Nur-Sultan
4,4,8,50.0,4,3,7,57.142857142857146,Egor Gerasimov,Frances Tiafoe,Egor Gerasimov,Nur-Sultan
21,4,25,84.0,11,2,13,84.61538461538461,Andrey Rublev,Andrey Rublev,Dominic Thiem,Vienna
13,2,15,86.66666666666667,9,1,10,90.0,Dominic Thiem,Andrey Rublev,Dominic Thiem,Vienna
5,7,12,41.666666666666664,4,4,8,50.0,John Millman,John Millman,Tommy Paul,Nur-Sultan
5,6,11,45.45454545454545,2,3,5,40.0,Tommy Paul,John Millman,Tommy Paul,Nur-Sultan
5,5,10,50.0,3,2,5,60.0,Kevin Anderson,Kevin Anderson,Daniil Medvedev,Vienna
10,5,15,66.66666666666667,10,3,13,76.92307692307692,Daniil Medvedev,Kevin Anderson,Daniil Medvedev,Vienna
5,7,12,41.666666666666664,5,4,9,55.55555555555556,Adrian Mannarino,Adrian Mannarino,Mackenzie McDonald,Nur-Sultan
3,4,7,42.857142857142854,2,3,5,40.0,Mackenzie McDonald,Adrian Mannarino,Mackenzie McDonald,Nur-Sultan
7,7,14,50.0,7,4,11,63.63636363636363,Daniel Evans,Daniel Evans,Grigor Dimitrov,Vienna
12,5,17,70.58823529411765,6,3,9,66.66666666666667,Grigor Dimitrov,Daniel Evans,Grigor Dimitrov,Vienna
4,6,10,40.0,4,4,8,50.0,Emil Ruusuvuori,Emil Ruusuvuori,Mikhail Kukushkin,Nur-Sultan
5,3,8,62.5,4,2,6,66.66666666666667,Mikhail Kukushkin,Emil Ruusuvuori,Mikhail Kukushkin,Nur-Sultan
7,6,13,53.84615384615385,2,2,4,50.0,Lorenzo Sonego,Lorenzo Sonego,Novak Djokovic,Vienna
21,2,23,91.30434782608695,10,1,11,90.9090909090909,Novak Djokovic,Lorenzo Sonego,Novak Djokovic,Vienna
6,7,13,46.15384615384615,5,4,9,55.55555555555556,John Millman,John Millman,Frances Tiafoe,Nur-Sultan
7,5,12,58.333333333333336,7,3,10,70.0,Frances Tiafoe,John Millman,Frances Tiafoe,Nur-Sultan
22,4,26,84.61538461538461,12,2,14,85.71428571428571,Andrey Rublev,Andrey Rublev,Kevin Anderson,Vienna
6,5,11,54.54545454545455,4,2,6,66.66666666666667,Kevin Anderson,Andrey Rublev,Kevin Anderson,Vienna
6,7,13,46.15384615384615,6,4,10,60.0,Adrian Mannarino,Adrian Mannarino,Emil Ruusuvuori,Nur-Sultan
5,6,11,45.45454545454545,5,4,9,55.55555555555556,Emil Ruusuvuori,Adrian Mannarino,Emil Ruusuvuori,Nur-Sultan
8,6,14,57.142857142857146,3,2,5,60.0,Lorenzo Sonego,Lorenzo Sonego,Daniel Evans,Vienna
8,7,15,53.333333333333336,8,4,12,66.66666666666667,Daniel Evans,Lorenzo Sonego,Daniel Evans,Vienna
7,7,14,50.0,6,4,10,60.0,John Millman,John Millman,Adrian Mannarino,Nur-Sultan
7,7,14,50.0,7,4,11,63.63636363636363,Adrian Mannarino,John Millman,Adrian Mannarino,Nur-Sultan
23,4,27,85.18518518518519,13,2,15,86.66666666666667,Andrey Rublev,Andrey Rublev,Lorenzo Sonego,Vienna
9,6,15,60.0,4,2,6,66.66666666666667,Lorenzo Sonego,Andrey Rublev,Lorenzo Sonego,Vienna
11,6,17,64.70588235294117,7,3,10,70.0,Ugo Humbert,Ugo Humbert,Casper Ruud,Paris Masters
11,7,18,61.111111111111114,2,3,5,40.0,Casper Ruud,Ugo Humbert,Casper Ruud,Paris Masters
3,5,8,37.5,2,3,5,40.0,Corentin Moutet,Corentin Moutet,Salvatore Caruso,Paris Masters
3,6,9,33.333333333333336,2,3,5,40.0,Salvatore Caruso,Corentin Moutet,Salvatore Caruso,Paris Masters
5,6,11,45.45454545454545,3,4,7,42.857142857142854,Marin Cilic,Marin Cilic,Felix Auger Aliassime,Paris Masters
10,8,18,55.55555555555556,9,5,14,64.28571428571429,Felix Auger Aliassime,Marin Cilic,Felix Auger Aliassime,Paris Masters
12,5,17,70.58823529411765,11,4,15,73.33333333333333,Milos Raonic,Milos Raonic,Aljaz Bedene,Paris Masters
4,5,9,44.44444444444444,2,4,6,33.333333333333336,Aljaz Bedene,Milos Raonic,Aljaz Bedene,Paris Masters
2,4,6,33.333333333333336,1,2,3,33.333333333333336,Pierre Hugues Herbert,Pierre Hugues Herbert,Tennys Sandgren,Paris Masters
3,8,11,27.272727272727273,2,5,7,28.571428571428573,Tennys Sandgren,Pierre Hugues Herbert,Tennys Sandgren,Paris Masters
5,5,10,50.0,4,4,8,50.0,Marcos Giron,Marcos Giron,Albert Ramos,Paris Masters
2,7,9,22.22222222222222,0,2,2,0.0,Albert Ramos,Marcos Giron,Albert Ramos,Paris Masters
6,6,12,50.0,4,3,7,57.142857142857146,Kevin Anderson,Kevin Anderson,Laslo Djere,Paris Masters
8,3,11,72.72727272727273,0,1,1,0.0,Laslo Djere,Kevin Anderson,Laslo Djere,Paris Masters
9,7,16,56.25,4,3,7,57.142857142857146,Lorenzo Sonego,Lorenzo Sonego,Alexander Bublik,Paris Masters
4,8,12,33.333333333333336,1,4,5,20.0,Alexander Bublik,Lorenzo Sonego,Alexander Bublik,Paris Masters
8,5,13,61.53846153846154,8,3,11,72.72727272727273,Alex De Minaur,Alex De Minaur,Stefano Travaglia,Paris Masters
4,5,9,44.44444444444444,0,2,2,0.0,Stefano Travaglia,Alex De Minaur,Stefano Travaglia,Paris Masters
9,5,14,64.28571428571429,8,3,11,72.72727272727273,Alejandro Davidovich Fokina,Alejandro Davidovich Fokina,Karen Khachanov,Paris Masters
11,8,19,57.89473684210526,7,5,12,58.333333333333336,Karen Khachanov,Alejandro Davidovich Fokina,Karen Khachanov,Paris Masters
1,1,2,50.0,0,0,0,,Benjamin Bonzi,Benjamin Bonzi,Federico Coria,Paris Masters
4,5,9,44.44444444444444,1,2,3,33.333333333333336,Federico Coria,Benjamin Bonzi,Federico Coria,Paris Masters
2,5,7,28.571428571428573,2,4,6,33.333333333333336,Richard Gasquet,Richard Gasquet,Taylor Fritz,Paris Masters
6,8,14,42.857142857142854,4,5,9,44.44444444444444,Taylor Fritz,Richard Gasquet,Taylor Fritz,Paris Masters
4,5,9,44.44444444444444,3,3,6,50.0,Radu Albot,Radu Albot,Hubert Hurkacz,Paris Masters
7,7,14,50.0,4,4,8,50.0,Hubert Hurkacz,Radu Albot,Hubert Hurkacz,Paris Masters
5,7,12,41.666666666666664,2,4,6,33.333333333333336,Tommy Paul,Tommy Paul,Gilles Simon,Paris Masters
4,5,9,44.44444444444444,4,3,7,57.142857142857146,Gilles Simon,Tommy Paul,Gilles Simon,Paris Masters
4,4,8,50.0,2,2,4,50.0,Stan Wawrinka,Stan Wawrinka,Daniel Evans,Paris Masters
8,8,16,50.0,8,5,13,61.53846153846154,Daniel Evans,Stan Wawrinka,Daniel Evans,Paris Masters
7,8,15,46.666666666666664,7,5,12,58.333333333333336,Adrian Mannarino,Adrian Mannarino,Dusan Lajovic,Paris Masters
5,9,14,35.714285714285715,0,4,4,0.0,Dusan Lajovic,Adrian Mannarino,Dusan Lajovic,Paris Masters
4,6,10,40.0,2,2,4,50.0,Yoshihito Nishioka,Yoshihito Nishioka,Pablo Andujar,Paris Masters
2,4,6,33.333333333333336,1,2,3,33.333333333333336,Pablo Andujar,Yoshihito Nishioka,Pablo Andujar,Paris Masters
8,6,14,57.142857142857146,3,4,7,42.857142857142854,Miomir Kecmanovic,Miomir Kecmanovic,John Millman,Paris Masters
8,7,15,53.333333333333336,7,4,11,63.63636363636363,John Millman,Miomir Kecmanovic,John Millman,Paris Masters
3,4,7,42.857142857142854,1,3,4,25.0,Norbert Gombos,Norbert Gombos,Marco Cecchinato,Paris Masters
7,5,12,58.333333333333336,0,2,2,0.0,Marco Cecchinato,Norbert Gombos,Marco Cecchinato,Paris Masters
7,8,15,46.666666666666664,6,5,11,54.54545454545455,Jan Lennard Struff,Jan Lennard Struff,Nikoloz Basilashvili,Paris Masters
0,6,6,0.0,0,2,2,0.0,Nikoloz Basilashvili,Jan Lennard Struff,Nikoloz Basilashvili,Paris Masters
11,6,17,64.70588235294117,7,4,11,63.63636363636363,Pablo Carreno Busta,Pablo Carreno Busta,Hugo Gaston,Paris Masters
3,1,4,75.0,0,0,0,,Hugo Gaston,Pablo Carreno Busta,Hugo Gaston,Paris Masters
11,6,17,64.70588235294117,10,4,14,71.42857142857143,Borna Coric,Borna Coric,Marton Fucsovics,Paris Masters
7,4,11,63.63636363636363,4,3,7,57.142857142857146,Marton Fucsovics,Borna Coric,Marton Fucsovics,Paris Masters
5,6,11,45.45454545454545,4,4,8,50.0,Jordan Thompson,Jordan Thompson,Federico Delbonis,Paris Masters
4,5,9,44.44444444444444,0,2,2,0.0,Federico Delbonis,Jordan Thompson,Federico Delbonis,Paris Masters
3,5,8,37.5,1,3,4,25.0,Feliciano Lopez,Feliciano Lopez,Filip Krajinovic,Paris Masters
7,6,13,53.84615384615385,5,4,9,55.55555555555556,Filip Krajinovic,Feliciano Lopez,Filip Krajinovic,Paris Masters
12,6,18,66.66666666666667,8,3,11,72.72727272727273,Ugo Humbert,Ugo Humbert,Stefanos Tsitsipas,Paris Masters
15,6,21,71.42857142857143,6,3,9,66.66666666666667,Stefanos Tsitsipas,Ugo Humbert,Stefanos Tsitsipas,Paris Masters
6,6,12,50.0,4,4,8,50.0,Marin Cilic,Marin Cilic,Corentin Moutet,Paris Masters
4,5,9,44.44444444444444,3,3,6,50.0,Corentin Moutet,Marin Cilic,Corentin Moutet,Paris Masters
13,5,18,72.22222222222223,12,4,16,75.0,Milos Raonic,Milos Raonic,Pierre Hugues Herbert,Paris Masters
3,4,7,42.857142857142854,2,2,4,50.0,Pierre Hugues Herbert,Milos Raonic,Pierre Hugues Herbert,Paris Masters
6,5,11,54.54545454545455,5,4,9,55.55555555555556,Marcos Giron,Marcos Giron,Matteo Berrettini,Paris Masters
8,4,12,66.66666666666667,4,2,6,66.66666666666667,Matteo Berrettini,Marcos Giron,Matteo Berrettini,Paris Masters
10,6,16,62.5,10,4,14,71.42857142857143,Daniil Medvedev,Daniil Medvedev,Kevin Anderson,Paris Masters
7,6,13,53.84615384615385,5,3,8,62.5,Kevin Anderson,Daniil Medvedev,Kevin Anderson,Paris Masters
9,5,14,64.28571428571429,9,3,12,75.0,Alex De Minaur,Alex De Minaur,Lorenzo Sonego,Paris Masters
10,7,17,58.8235294117647,5,3,8,62.5,Lorenzo Sonego,Alex De Minaur,Lorenzo Sonego,Paris Masters
10,5,15,66.66666666666667,9,3,12,75.0,Alejandro Davidovich Fokina,Alejandro Davidovich Fokina,Benjamin Bonzi,Paris Masters
2,1,3,66.66666666666667,1,0,1,100.0,Benjamin Bonzi,Alejandro Davidovich Fokina,Benjamin Bonzi,Paris Masters
14,6,20,70.0,4,3,7,57.142857142857146,Diego Schwartzman,Diego Schwartzman,Richard Gasquet,Paris Masters
3,5,8,37.5,3,4,7,42.857142857142854,Richard Gasquet,Diego Schwartzman,Richard Gasquet,Paris Masters
24,4,28,85.71428571428571,14,2,16,87.5,Andrey Rublev,Andrey Rublev,Radu Albot,Paris Masters
5,5,10,50.0,4,3,7,57.142857142857146,Radu Albot,Andrey Rublev,Radu Albot,Paris Masters
5,4,9,55.55555555555556,3,2,5,60.0,Stan Wawrinka,Stan Wawrinka,Tommy Paul,Paris Masters
6,7,13,46.15384615384615,3,4,7,42.857142857142854,Tommy Paul,Stan Wawrinka,Tommy Paul,Paris Masters
8,8,16,50.0,8,5,13,61.53846153846154,Adrian Mannarino,Adrian Mannarino,Yoshihito Nishioka,Paris Masters
5,6,11,45.45454545454545,3,2,5,60.0,Yoshihito Nishioka,Adrian Mannarino,Yoshihito Nishioka,Paris Masters
17,3,20,85.0,14,2,16,87.5,Alexander Zverev,Alexander Zverev,Miomir Kecmanovic,Paris Masters
9,6,15,60.0,4,4,8,50.0,Miomir Kecmanovic,Alexander Zverev,Miomir Kecmanovic,Paris Masters
4,4,8,50.0,2,3,5,40.0,Norbert Gombos,Norbert Gombos,David Goffin,Paris Masters
4,5,9,44.44444444444444,4,3,7,57.142857142857146,David Goffin,Norbert Gombos,David Goffin,Paris Masters
12,6,18,66.66666666666667,8,4,12,66.66666666666667,Pablo Carreno Busta,Pablo Carreno Busta,Jan Lennard Struff,Paris Masters
8,8,16,50.0,7,5,12,58.333333333333336,Jan Lennard Struff,Pablo Carreno Busta,Jan Lennard Struff,Paris Masters
6,6,12,50.0,5,4,9,55.55555555555556,Jordan Thompson,Jordan Thompson,Borna Coric,Paris Masters
12,6,18,66.66666666666667,11,4,15,73.33333333333333,Borna Coric,Jordan Thompson,Borna Coric,Paris Masters
9,1,10,90.0,0,0,0,,Rafael Nadal,Rafael Nadal,Feliciano Lopez,Paris Masters
4,5,9,44.44444444444444,2,3,5,40.0,Feliciano Lopez,Rafael Nadal,Feliciano Lopez,Paris Masters
13,6,19,68.42105263157895,9,3,12,75.0,Ugo Humbert,Ugo Humbert,Marin Cilic,Paris Masters
7,6,13,53.84615384615385,5,4,9,55.55555555555556,Marin Cilic,Ugo Humbert,Marin Cilic,Paris Masters
14,5,19,73.6842105263158,13,4,17,76.47058823529412,Milos Raonic,Milos Raonic,Marcos Giron,Paris Masters
7,5,12,58.333333333333336,6,4,10,60.0,Marcos Giron,Milos Raonic,Marcos Giron,Paris Masters
11,6,17,64.70588235294117,11,4,15,73.33333333333333,Daniil Medvedev,Daniil Medvedev,Alex De Minaur,Paris Masters
10,5,15,66.66666666666667,10,3,13,76.92307692307692,Alex De Minaur,Daniil Medvedev,Alex De Minaur,Paris Masters
15,6,21,71.42857142857143,5,3,8,62.5,Diego Schwartzman,Diego Schwartzman,Alejandro Davidovich Fokina,Paris Masters
11,5,16,68.75,10,3,13,76.92307692307692,Alejandro Davidovich Fokina,Diego Schwartzman,Alejandro Davidovich Fokina,Paris Masters
6,4,10,60.0,4,2,6,66.66666666666667,Stan Wawrinka,Stan Wawrinka,Andrey Rublev,Paris Masters
25,4,29,86.20689655172414,15,2,17,88.23529411764706,Andrey Rublev,Stan Wawrinka,Andrey Rublev,Paris Masters
18,3,21,85.71428571428571,15,2,17,88.23529411764706,Alexander Zverev,Alexander Zverev,Adrian Mannarino,Paris Masters
9,8,17,52.94117647058823,9,5,14,64.28571428571429,Adrian Mannarino,Alexander Zverev,Adrian Mannarino,Paris Masters
13,6,19,68.42105263157895,9,4,13,69.23076923076923,Pablo Carreno Busta,Pablo Carreno Busta,Norbert Gombos,Paris Masters
5,4,9,55.55555555555556,3,3,6,50.0,Norbert Gombos,Pablo Carreno Busta,Norbert Gombos,Paris Masters
10,1,11,90.9090909090909,1,0,1,100.0,Rafael Nadal,Rafael Nadal,Jordan Thompson,Paris Masters
7,6,13,53.84615384615385,6,4,10,60.0,Jordan Thompson,Rafael Nadal,Jordan Thompson,Paris Masters
15,5,20,75.0,14,4,18,77.77777777777777,Milos Raonic,Milos Raonic,Ugo Humbert,Paris Masters
14,6,20,70.0,10,3,13,76.92307692307692,Ugo Humbert,Milos Raonic,Ugo Humbert,Paris Masters
12,6,18,66.66666666666667,12,4,16,75.0,Daniil Medvedev,Daniil Medvedev,Diego Schwartzman,Paris Masters
16,6,22,72.72727272727273,6,3,9,66.66666666666667,Diego Schwartzman,Daniil Medvedev,Diego Schwartzman,Paris Masters
19,3,22,86.36363636363636,16,2,18,88.88888888888889,Alexander Zverev,Alexander Zverev,Stan Wawrinka,Paris Masters
7,4,11,63.63636363636363,5,2,7,71.42857142857143,Stan Wawrinka,Alexander Zverev,Stan Wawrinka,Paris Masters
11,1,12,91.66666666666667,2,0,2,100.0,Rafael Nadal,Rafael Nadal,Pablo Carreno Busta,Paris Masters
14,6,20,70.0,10,4,14,71.42857142857143,Pablo Carreno Busta,Rafael Nadal,Pablo Carreno Busta,Paris Masters
13,6,19,68.42105263157895,13,4,17,76.47058823529412,Daniil Medvedev,Daniil Medvedev,Milos Raonic,Paris Masters
16,5,21,76.19047619047619,15,4,19,78.94736842105263,Milos Raonic,Daniil Medvedev,Milos Raonic,Paris Masters
20,3,23,86.95652173913044,17,2,19,89.47368421052632,Alexander Zverev,Alexander Zverev,Rafael Nadal,Paris Masters
12,1,13,92.3076923076923,3,0,3,100.0,Rafael Nadal,Alexander Zverev,Rafael Nadal,Paris Masters
14,6,20,70.0,14,4,18,77.77777777777777,Daniil Medvedev,Daniil Medvedev,Alexander Zverev,Paris Masters
21,3,24,87.5,18,2,20,90.0,Alexander Zverev,Daniil Medvedev,Alexander Zverev,Paris Masters
3,7,10,30.0,2,4,6,33.333333333333336,Salvatore Caruso,Salvatore Caruso,Dimitar Kuzmanov,Sofia
0,0,0,,0,0,0,,Dimitar Kuzmanov,Salvatore Caruso,Dimitar Kuzmanov,Sofia
3,6,9,33.333333333333336,3,5,8,37.5,Richard Gasquet,Richard Gasquet,Roberto Carballes Baena,Sofia
4,3,7,57.142857142857146,1,1,2,50.0,Roberto Carballes Baena,Richard Gasquet,Roberto Carballes Baena,Sofia
0,0,0,,0,0,0,,Jonas Forejtek,Jonas Forejtek,Marin Cilic,Sofia
7,7,14,50.0,5,5,10,50.0,Marin Cilic,Jonas Forejtek,Marin Cilic,Sofia
4,4,8,50.0,4,3,7,57.142857142857146,Vasek Pospisil,Vasek Pospisil,Illya Marchenko,Sofia
0,0,0,,0,0,0,,Illya Marchenko,Vasek Pospisil,Illya Marchenko,Sofia
4,6,10,40.0,4,4,8,50.0,Gilles Simon,Gilles Simon,Andrej Martin,Sofia
1,3,4,25.0,0,1,1,0.0,Andrej Martin,Gilles Simon,Andrej Martin,Sofia
8,8,16,50.0,7,5,12,58.333333333333336,John Millman,John Millman,Adrian Andreev,Sofia
0,0,0,,0,0,0,,Adrian Andreev,John Millman,Adrian Andreev,Sofia
3,1,4,75.0,0,0,0,,Marc Andrea Huesler,Marc Andrea Huesler,Nikoloz Basilashvili,Sofia
0,7,7,0.0,0,3,3,0.0,Nikoloz Basilashvili,Marc Andrea Huesler,Nikoloz Basilashvili,Sofia
11,6,17,64.70588235294117,4,3,7,57.142857142857146,Jannik Sinner,Jannik Sinner,Marton Fucsovics,Sofia
7,5,12,58.333333333333336,4,4,8,50.0,Marton Fucsovics,Jannik Sinner,Marton Fucsovics,Sofia
1,2,3,33.333333333333336,1,2,3,33.333333333333336,Aslan Karatsev,Aslan Karatsev,Taro Daniel,Sofia
0,1,1,0.0,0,1,1,0.0,Taro Daniel,Aslan Karatsev,Taro Daniel,Sofia
9,9,18,50.0,9,6,15,60.0,Adrian Mannarino,Adrian Mannarino,Martin Klizan,Sofia
0,0,0,,0,0,0,,Martin Klizan,Adrian Mannarino,Martin Klizan,Sofia
4,5,9,44.44444444444444,4,4,8,50.0,Egor Gerasimov,Egor Gerasimov,Viktor Troicki,Sofia
0,1,1,0.0,0,1,1,0.0,Viktor Troicki,Egor Gerasimov,Viktor Troicki,Sofia
5,6,11,45.45454545454545,4,4,8,50.0,Radu Albot,Radu Albot,Yuichi Sugita,Sofia
1,3,4,25.0,1,2,3,33.333333333333336,Yuichi Sugita,Radu Albot,Yuichi Sugita,Sofia
4,7,11,36.36363636363637,3,4,7,42.857142857142854,Salvatore Caruso,Salvatore Caruso,Felix Auger Aliassime,Sofia
10,9,19,52.63157894736842,9,6,15,60.0,Felix Auger Aliassime,Salvatore Caruso,Felix Auger Aliassime,Sofia
4,6,10,40.0,4,5,9,44.44444444444444,Richard Gasquet,Richard Gasquet,Jonas Forejtek,Sofia
1,0,1,100.0,1,0,1,100.0,Jonas Forejtek,Richard Gasquet,Jonas Forejtek,Sofia
5,4,9,55.55555555555556,5,3,8,62.5,Vasek Pospisil,Vasek Pospisil,Jan Lennard Struff,Sofia
8,9,17,47.05882352941177,7,6,13,53.84615384615385,Jan Lennard Struff,Vasek Pospisil,Jan Lennard Struff,Sofia
9,8,17,52.94117647058823,8,5,13,61.53846153846154,John Millman,John Millman,Gilles Simon,Sofia
5,6,11,45.45454545454545,5,4,9,55.55555555555556,Gilles Simon,John Millman,Gilles Simon,Sofia
12,6,18,66.66666666666667,5,3,8,62.5,Jannik Sinner,Jannik Sinner,Marc Andrea Huesler,Sofia
4,1,5,80.0,1,0,1,100.0,Marc Andrea Huesler,Jannik Sinner,Marc Andrea Huesler,Sofia
10,6,16,62.5,10,4,14,71.42857142857143,Alex De Minaur,Alex De Minaur,Aslan Karatsev,Sofia
2,2,4,50.0,2,2,4,50.0,Aslan Karatsev,Alex De Minaur,Aslan Karatsev,Sofia
10,9,19,52.63157894736842,10,6,16,62.5,Adrian Mannarino,Adrian Mannarino,Egor Gerasimov,Sofia
5,5,10,50.0,5,4,9,55.55555555555556,Egor Gerasimov,Adrian Mannarino,Egor Gerasimov,Sofia
6,6,12,50.0,5,4,9,55.55555555555556,Radu Albot,Radu Albot,Denis Shapovalov,Sofia
13,7,20,65.0,8,5,13,61.53846153846154,Denis Shapovalov,Radu Albot,Denis Shapovalov,Sofia
5,6,11,45.45454545454545,5,5,10,50.0,Richard Gasquet,Richard Gasquet,Salvatore Caruso,Sofia
5,7,12,41.666666666666664,4,4,8,50.0,Salvatore Caruso,Richard Gasquet,Salvatore Caruso,Sofia
6,4,10,60.0,6,3,9,66.66666666666667,Vasek Pospisil,Vasek Pospisil,John Millman,Sofia
10,8,18,55.55555555555556,9,5,14,64.28571428571429,John Millman,Vasek Pospisil,John Millman,Sofia
13,6,19,68.42105263157895,6,3,9,66.66666666666667,Jannik Sinner,Jannik Sinner,Alex De Minaur,Sofia
11,6,17,64.70588235294117,11,4,15,73.33333333333333,Alex De Minaur,Jannik Sinner,Alex De Minaur,Sofia
11,9,20,55.0,11,6,17,64.70588235294117,Adrian Mannarino,Adrian Mannarino,Radu Albot,Sofia
7,6,13,53.84615384615385,6,4,10,60.0,Radu Albot,Adrian Mannarino,Radu Albot,Sofia
7,4,11,63.63636363636363,7,3,10,70.0,Vasek Pospisil,Vasek Pospisil,Richard Gasquet,Sofia
6,6,12,50.0,6,5,11,54.54545454545455,Richard Gasquet,Vasek Pospisil,Richard Gasquet,Sofia
14,6,20,70.0,7,3,10,70.0,Jannik Sinner,Jannik Sinner,Adrian Mannarino,Sofia
12,9,21,57.142857142857146,12,6,18,66.66666666666667,Adrian Mannarino,Jannik Sinner,Adrian Mannarino,Sofia
15,6,21,71.42857142857143,8,3,11,72.72727272727273,Jannik Sinner,Jannik Sinner,Vasek Pospisil,Sofia
8,4,12,66.66666666666667,8,3,11,72.72727272727273,Vasek Pospisil,Jannik Sinner,Vasek Pospisil,Sofia
15,7,22,68.18181818181819,6,4,10,60.0,Stefanos Tsitsipas,Stefanos Tsitsipas,Andrey Rublev,Tour Finals
25,5,30,83.33333333333333,15,3,18,83.33333333333333,Andrey Rublev,Stefanos Tsitsipas,Andrey Rublev,Tour Finals
25,6,31,80.64516129032258,15,4,19,78.94736842105263,Andrey Rublev,Andrey Rublev,Dominic Thiem,Tour Finals
13,3,16,81.25,9,2,11,81.81818181818181,Dominic Thiem,Andrey Rublev,Dominic Thiem,Tour Finals
13,4,17,76.47058823529412,9,3,12,75.0,Dominic Thiem,Dominic Thiem,Stefanos Tsitsipas,Tour Finals
16,7,23,69.56521739130434,7,4,11,63.63636363636363,Stefanos Tsitsipas,Dominic Thiem,Stefanos Tsitsipas,Tour Finals
12,2,14,85.71428571428571,3,1,4,75.0,Rafael Nadal,Rafael Nadal,Andrey Rublev,Tour Finals
26,6,32,81.25,16,4,20,80.0,Andrey Rublev,Rafael Nadal,Andrey Rublev,Tour Finals
13,2,15,86.66666666666667,4,1,5,80.0,Rafael Nadal,Rafael Nadal,Stefanos Tsitsipas,Tour Finals
16,8,24,66.66666666666667,7,5,12,58.333333333333336,Stefanos Tsitsipas,Rafael Nadal,Stefanos Tsitsipas,Tour Finals
14,4,18,77.77777777777777,10,3,13,76.92307692307692,Dominic Thiem,Dominic Thiem,Rafael Nadal,Tour Finals
14,2,16,87.5,5,1,6,83.33333333333333,Rafael Nadal,Dominic Thiem,Rafael Nadal,Tour Finals
21,4,25,84.0,18,3,21,85.71428571428571,Alexander Zverev,Alexander Zverev,Diego Schwartzman,Tour Finals
16,7,23,69.56521739130434,6,4,10,60.0,Diego Schwartzman,Alexander Zverev,Diego Schwartzman,Tour Finals
15,6,21,71.42857142857143,15,4,19,78.94736842105263,Daniil Medvedev,Daniil Medvedev,Diego Schwartzman,Tour Finals
16,8,24,66.66666666666667,6,5,11,54.54545454545455,Diego Schwartzman,Daniil Medvedev,Diego Schwartzman,Tour Finals
16,6,22,72.72727272727273,16,4,20,80.0,Daniil Medvedev,Daniil Medvedev,Alexander Zverev,Tour Finals
22,4,26,84.61538461538461,19,3,22,86.36363636363636,Alexander Zverev,Daniil Medvedev,Alexander Zverev,Tour Finals
21,3,24,87.5,10,2,12,83.33333333333333,Novak Djokovic,Novak Djokovic,Diego Schwartzman,Tour Finals
16,9,25,64.0,6,6,12,50.0,Diego Schwartzman,Novak Djokovic,Diego Schwartzman,Tour Finals
22,3,25,88.0,11,2,13,84.61538461538461,Novak Djokovic,Novak Djokovic,Alexander Zverev,Tour Finals
22,5,27,81.48148148148148,19,4,23,82.6086956521739,Alexander Zverev,Novak Djokovic,Alexander Zverev,Tour Finals
17,6,23,73.91304347826087,17,4,21,80.95238095238095,Daniil Medvedev,Daniil Medvedev,Novak Djokovic,Tour Finals
23,3,26,88.46153846153847,12,2,14,85.71428571428571,Novak Djokovic,Daniil Medvedev,Novak Djokovic,Tour Finals
15,4,19,78.94736842105263,11,3,14,78.57142857142857,Dominic Thiem,Dominic Thiem,Novak Djokovic,Tour Finals
23,4,27,85.18518518518519,12,3,15,80.0,Novak Djokovic,Dominic Thiem,Novak Djokovic,Tour Finals
18,6,24,75.0,18,4,22,81.81818181818181,Daniil Medvedev,Daniil Medvedev,Rafael Nadal,Tour Finals
14,3,17,82.3529411764706,5,2,7,71.42857142857143,Rafael Nadal,Daniil Medvedev,Rafael Nadal,Tour Finals
19,6,25,76.0,19,4,23,82.6086956521739,Daniil Medvedev,Daniil Medvedev,Dominic Thiem,Tour Finals
16,4,20,80.0,12,3,15,80.0,Dominic Thiem,Daniil Medvedev,Dominic Thiem,Tour Finals
2,1,3,66.66666666666667,0,0,0,,Thiago Monteiro,Thiago Monteiro,Thomaz Bellucci,Delray Beach
0,0,0,,0,0,0,,Thomaz Bellucci,Thiago Monteiro,Thomaz Bellucci,Delray Beach
3,1,4,75.0,0,0,0,,Sebastian Korda,Sebastian Korda,Soon Woo Kwon,Delray Beach
0,1,1,0.0,0,0,0,,Soon Woo Kwon,Sebastian Korda,Soon Woo Kwon,Delray Beach
6,6,12,50.0,3,3,6,50.0,Tommy Paul,Tommy Paul,Ji Sung Nam,Delray Beach
0,0,0,,0,0,0,,Ji Sung Nam,Tommy Paul,Ji Sung Nam,Delray Beach
3,4,7,42.857142857142854,3,3,6,50.0,Cameron Norrie,Cameron Norrie,Jc Aragone,Delray Beach
0,0,0,,0,0,0,,Jc Aragone,Cameron Norrie,Jc Aragone,Delray Beach
0,0,0,,0,0,0,,Bjorn Fratangelo,Bjorn Fratangelo,Kevin King,Delray Beach
0,0,0,,0,0,0,,Kevin King,Bjorn Fratangelo,Kevin King,Delray Beach
4,4,8,50.0,4,2,6,66.66666666666667,Frances Tiafoe,Frances Tiafoe,Donald Young,Delray Beach
0,0,0,,0,0,0,,Donald Young,Frances Tiafoe,Donald Young,Delray Beach
0,0,0,,0,0,0,,Ivo Karlovic,Ivo Karlovic,Pablo Andujar,Delray Beach
2,4,6,33.333333333333336,1,2,3,33.333333333333336,Pablo Andujar,Ivo Karlovic,Pablo Andujar,Delray Beach
0,0,0,,0,0,0,,Roberto Quiroz,Roberto Quiroz,Noah Rubin,Delray Beach
0,0,0,,0,0,0,,Noah Rubin,Roberto Quiroz,Noah Rubin,Delray Beach
2,1,3,66.66666666666667,0,0,0,,Daniel Elahi Galan,Daniel Elahi Galan,Andrej Martin,Delray Beach
1,3,4,25.0,0,1,1,0.0,Andrej Martin,Daniel Elahi Galan,Andrej Martin,Delray Beach
0,2,2,0.0,0,0,0,,Sam Querrey,Sam Querrey,Mackenzie McDonald,Delray Beach
3,3,6,50.0,2,2,4,50.0,Mackenzie McDonald,Sam Querrey,Mackenzie McDonald,Delray Beach
0,3,3,0.0,0,0,0,,Gianluca Mager,Gianluca Mager,Ryan Harrison,Delray Beach
0,0,0,,0,0,0,,Ryan Harrison,Gianluca Mager,Ryan Harrison,Delray Beach
0,0,0,,0,0,0,,Christian Harrison,Christian Harrison,Tomas Martin Etcheverry,Delray Beach
0,0,0,,0,0,0,,Tomas Martin Etcheverry,Christian Harrison,Tomas Martin Etcheverry,Delray Beach
1,1,2,50.0,0,0,0,,John Isner,John Isner,Thiago Monteiro,Delray Beach
3,1,4,75.0,1,0,1,100.0,Thiago Monteiro,John Isner,Thiago Monteiro,Delray Beach
4,1,5,80.0,1,0,1,100.0,Sebastian Korda,Sebastian Korda,Tommy Paul,Delray Beach
7,6,13,53.84615384615385,4,3,7,57.142857142857146,Tommy Paul,Sebastian Korda,Tommy Paul,Delray Beach
4,4,8,50.0,4,3,7,57.142857142857146,Cameron Norrie,Cameron Norrie,Adrian Mannarino,Delray Beach
10,8,18,55.55555555555556,10,5,15,66.66666666666667,Adrian Mannarino,Cameron Norrie,Adrian Mannarino,Delray Beach
5,4,9,55.55555555555556,5,2,7,71.42857142857143,Frances Tiafoe,Frances Tiafoe,Bjorn Fratangelo,Delray Beach
1,0,1,100.0,1,0,1,100.0,Bjorn Fratangelo,Frances Tiafoe,Bjorn Fratangelo,Delray Beach
1,0,1,100.0,1,0,1,100.0,Roberto Quiroz,Roberto Quiroz,Ivo Karlovic,Delray Beach
1,0,1,100.0,1,0,1,100.0,Ivo Karlovic,Roberto Quiroz,Ivo Karlovic,Delray Beach
6,6,12,50.0,3,3,6,50.0,Hubert Hurkacz,Hubert Hurkacz,Daniel Elahi Galan,Delray Beach
3,1,4,75.0,1,0,1,100.0,Daniel Elahi Galan,Hubert Hurkacz,Daniel Elahi Galan,Delray Beach
1,3,4,25.0,1,0,1,100.0,Gianluca Mager,Gianluca Mager,Sam Querrey,Delray Beach
1,2,3,33.333333333333336,1,0,1,100.0,Sam Querrey,Gianluca Mager,Sam Querrey,Delray Beach
1,0,1,100.0,1,0,1,100.0,Christian Harrison,Christian Harrison,Christian Garin,Delray Beach
6,4,10,60.0,1,1,2,50.0,Christian Garin,Christian Harrison,Christian Garin,Delray Beach
5,1,6,83.33333333333333,2,0,2,100.0,Sebastian Korda,Sebastian Korda,John Isner,Delray Beach
2,1,3,66.66666666666667,1,0,1,100.0,John Isner,Sebastian Korda,John Isner,Delray Beach
5,4,9,55.55555555555556,5,3,8,62.5,Cameron Norrie,Cameron Norrie,Frances Tiafoe,Delray Beach
6,4,10,60.0,6,2,8,75.0,Frances Tiafoe,Cameron Norrie,Frances Tiafoe,Delray Beach
7,6,13,53.84615384615385,4,3,7,57.142857142857146,Hubert Hurkacz,Hubert Hurkacz,Roberto Quiroz,Delray Beach
2,0,2,100.0,2,0,2,100.0,Roberto Quiroz,Hubert Hurkacz,Roberto Quiroz,Delray Beach
2,0,2,100.0,2,0,2,100.0,Christian Harrison,Christian Harrison,Gianluca Mager,Delray Beach
2,3,5,40.0,2,0,2,100.0,Gianluca Mager,Christian Harrison,Gianluca Mager,Delray Beach
6,1,7,85.71428571428571,3,0,3,100.0,Sebastian Korda,Sebastian Korda,Cameron Norrie,Delray Beach
6,4,10,60.0,6,3,9,66.66666666666667,Cameron Norrie,Sebastian Korda,Cameron Norrie,Delray Beach
8,6,14,57.142857142857146,5,3,8,62.5,Hubert Hurkacz,Hubert Hurkacz,Christian Harrison,Delray Beach
3,0,3,100.0,3,0,3,100.0,Christian Harrison,Hubert Hurkacz,Christian Harrison,Delray Beach
9,6,15,60.0,6,3,9,66.66666666666667,Hubert Hurkacz,Hubert Hurkacz,Sebastian Korda,Delray Beach
7,1,8,87.5,4,0,4,100.0,Sebastian Korda,Hubert Hurkacz,Sebastian Korda,Delray Beach
0,4,4,0.0,0,2,2,0.0,David Goffin,David Goffin,Pierre Hugues Herbert,Antalya
3,5,8,37.5,2,3,5,40.0,Pierre Hugues Herbert,David Goffin,Pierre Hugues Herbert,Antalya
0,0,0,,0,0,0,,Nicola Kuhn,Nicola Kuhn,Matthias Bachinger,Antalya
0,0,0,,0,0,0,,Matthias Bachinger,Nicola Kuhn,Matthias Bachinger,Antalya
3,5,8,37.5,3,3,6,50.0,Emil Ruusuvuori,Emil Ruusuvuori,Jiri Vesely,Antalya
5,4,9,55.55555555555556,1,1,2,50.0,Jiri Vesely,Emil Ruusuvuori,Jiri Vesely,Antalya
4,5,9,44.44444444444444,0,2,2,0.0,Stefano Travaglia,Stefano Travaglia,Miomir Kecmanovic,Antalya
8,6,14,57.142857142857146,3,4,7,42.857142857142854,Miomir Kecmanovic,Stefano Travaglia,Miomir Kecmanovic,Antalya
7,5,12,58.333333333333336,7,3,10,70.0,Alex De Minaur,Alex De Minaur,Malek Jaziri,Antalya
0,0,0,,0,0,0,,Malek Jaziri,Alex De Minaur,Malek Jaziri,Antalya
0,1,1,0.0,0,1,1,0.0,Adrian Andreev,Adrian Andreev,Marsel Ilhan,Antalya
0,0,0,,0,0,0,,Marsel Ilhan,Adrian Andreev,Marsel Ilhan,Antalya
0,0,0,,0,0,0,,Altug Celikbilek,Altug Celikbilek,Kacper Zuk,Antalya
0,0,0,,0,0,0,,Kacper Zuk,Altug Celikbilek,Kacper Zuk,Antalya
0,6,6,0.0,0,2,2,0.0,Nikoloz Basilashvili,Nikoloz Basilashvili,Andrea Arnaboldi,Antalya
0,0,0,,0,0,0,,Andrea Arnaboldi,Nikoloz Basilashvili,Andrea Arnaboldi,Antalya
3,8,11,27.272727272727273,2,5,7,28.571428571428573,Jan Lennard Struff,Jan Lennard Struff,Pavel Kotov,Antalya
0,1,1,0.0,0,1,1,0.0,Pavel Kotov,Jan Lennard Struff,Pavel Kotov,Antalya
0,0,0,,0,0,0,,Hugo Grenier,Hugo Grenier,Alex Molcan,Antalya
0,0,0,,0,0,0,,Alex Molcan,Hugo Grenier,Alex Molcan,Antalya
0,1,1,0.0,0,0,0,,Jeremy Chardy,Jeremy Chardy,Radu Albot,Antalya
7,6,13,53.84615384615385,6,4,10,60.0,Radu Albot,Jeremy Chardy,Radu Albot,Antalya
1,4,5,20.0,0,0,0,,Fabio Fognini,Fabio Fognini,Michael Vrbensky,Antalya
0,0,0,,0,0,0,,Michael Vrbensky,Fabio Fognini,Michael Vrbensky,Antalya
4,7,11,36.36363636363637,1,3,4,25.0,Alexander Bublik,Alexander Bublik,Salvatore Caruso,Antalya
3,6,9,33.333333333333336,2,3,5,40.0,Salvatore Caruso,Alexander Bublik,Salvatore Caruso,Antalya
0,0,0,,0,0,0,,Tristan Lamasine,Tristan Lamasine,Egor Gerasimov,Antalya
4,5,9,44.44444444444444,4,4,8,50.0,Egor Gerasimov,Tristan Lamasine,Egor Gerasimov,Antalya
0,1,1,0.0,0,1,1,0.0,Dimitar Kuzmanov,Dimitar Kuzmanov,Laslo Djere,Antalya
8,3,11,72.72727272727273,0,1,1,0.0,Laslo Djere,Dimitar Kuzmanov,Laslo Djere,Antalya
4,3,7,57.142857142857146,0,1,1,0.0,Matteo Berrettini,Matteo Berrettini,Ergi Kirkin,Antalya
0,0,0,,0,0,0,,Ergi Kirkin,Matteo Berrettini,Ergi Kirkin,Antalya
1,4,5,20.0,1,2,3,33.333333333333336,David Goffin,David Goffin,Nicola Kuhn,Antalya
1,0,1,100.0,1,0,1,100.0,Nicola Kuhn,David Goffin,Nicola Kuhn,Antalya
5,5,10,50.0,1,2,3,33.333333333333336,Stefano Travaglia,Stefano Travaglia,Emil Ruusuvuori,Antalya
4,5,9,44.44444444444444,4,3,7,57.142857142857146,Emil Ruusuvuori,Stefano Travaglia,Emil Ruusuvuori,Antalya
8,5,13,61.53846153846154,8,3,11,72.72727272727273,Alex De Minaur,Alex De Minaur,Adrian Andreev,Antalya
1,1,2,50.0,1,1,2,50.0,Adrian Andreev,Alex De Minaur,Adrian Andreev,Antalya
1,6,7,14.285714285714286,1,2,3,33.333333333333336,Nikoloz Basilashvili,Nikoloz Basilashvili,Altug Celikbilek,Antalya
1,0,1,100.0,1,0,1,100.0,Altug Celikbilek,Nikoloz Basilashvili,Altug Celikbilek,Antalya
4,8,12,33.333333333333336,3,5,8,37.5,Jan Lennard Struff,Jan Lennard Struff,Hugo Grenier,Antalya
1,0,1,100.0,1,0,1,100.0,Hugo Grenier,Jan Lennard Struff,Hugo Grenier,Antalya
1,1,2,50.0,1,0,1,100.0,Jeremy Chardy,Jeremy Chardy,Fabio Fognini,Antalya
2,4,6,33.333333333333336,1,0,1,100.0,Fabio Fognini,Jeremy Chardy,Fabio Fognini,Antalya
5,7,12,41.666666666666664,2,3,5,40.0,Alexander Bublik,Alexander Bublik,Tristan Lamasine,Antalya
1,0,1,100.0,1,0,1,100.0,Tristan Lamasine,Alexander Bublik,Tristan Lamasine,Antalya
5,3,8,62.5,1,1,2,50.0,Matteo Berrettini,Matteo Berrettini,Dimitar Kuzmanov,Antalya
1,1,2,50.0,1,1,2,50.0,Dimitar Kuzmanov,Matteo Berrettini,Dimitar Kuzmanov,Antalya
2,4,6,33.333333333333336,2,2,4,50.0,David Goffin,David Goffin,Stefano Travaglia,Antalya
6,5,11,54.54545454545455,2,2,4,50.0,Stefano Travaglia,David Goffin,Stefano Travaglia,Antalya
9,5,14,64.28571428571429,9,3,12,75.0,Alex De Minaur,Alex De Minaur,Nikoloz Basilashvili,Antalya
2,6,8,25.0,2,2,4,50.0,Nikoloz Basilashvili,Alex De Minaur,Nikoloz Basilashvili,Antalya
2,1,3,66.66666666666667,2,0,2,100.0,Jeremy Chardy,Jeremy Chardy,Jan Lennard Struff,Antalya
5,8,13,38.46153846153846,4,5,9,44.44444444444444,Jan Lennard Struff,Jeremy Chardy,Jan Lennard Struff,Antalya
6,7,13,46.15384615384615,3,3,6,50.0,Alexander Bublik,Alexander Bublik,Matteo Berrettini,Antalya
6,3,9,66.66666666666667,2,1,3,66.66666666666667,Matteo Berrettini,Alexander Bublik,Matteo Berrettini,Antalya
10,5,15,66.66666666666667,10,3,13,76.92307692307692,Alex De Minaur,Alex De Minaur,David Goffin,Antalya
3,4,7,42.857142857142854,3,2,5,60.0,David Goffin,Alex De Minaur,David Goffin,Antalya
7,7,14,50.0,4,3,7,57.142857142857146,Alexander Bublik,Alexander Bublik,Jeremy Chardy,Antalya
3,1,4,75.0,3,0,3,100.0,Jeremy Chardy,Alexander Bublik,Jeremy Chardy,Antalya
11,5,16,68.75,11,3,14,78.57142857142857,Alex De Minaur,Alex De Minaur,Alexander Bublik,Antalya
8,7,15,53.333333333333336,5,3,8,62.5,Alexander Bublik,Alex De Minaur,Alexander Bublik,Antalya
0,0,0,,0,0,0,,Max Purcell,Max Purcell,Norbert Gombos,Great Ocean Road Open
2,2,4,50.0,2,2,4,50.0,Norbert Gombos,Max Purcell,Norbert Gombos,Great Ocean Road Open
0,0,0,,0,0,0,,Andrew Harris,Andrew Harris,Taro Daniel,Murray River Open
0,1,1,0.0,0,1,1,0.0,Taro Daniel,Andrew Harris,Taro Daniel,Murray River Open
0,0,0,,0,0,0,,Cedrik Marcel Stebe,Cedrik Marcel Stebe,Hugo Dellien,Great Ocean Road Open
0,0,0,,0,0,0,,Hugo Dellien,Cedrik Marcel Stebe,Hugo Dellien,Great Ocean Road Open
0,1,1,0.0,0,1,1,0.0,Alexei Popyrin,Alexei Popyrin,Borna Gojo,Murray River Open
0,0,0,,0,0,0,,Borna Gojo,Alexei Popyrin,Borna Gojo,Murray River Open
4,2,6,66.66666666666667,4,2,6,66.66666666666667,Kevin Anderson,Kevin Anderson,Feliciano Lopez,Great Ocean Road Open
2,3,5,40.0,2,3,5,40.0,Feliciano Lopez,Kevin Anderson,Feliciano Lopez,Great Ocean Road Open
5,5,10,50.0,4,4,8,50.0,Tommy Paul,Tommy Paul,Cameron Norrie,Murray River Open
6,4,10,60.0,6,4,10,60.0,Cameron Norrie,Tommy Paul,Cameron Norrie,Murray River Open
0,1,1,0.0,0,0,0,,Kamil Majchrzak,Kamil Majchrzak,Laslo Djere,Great Ocean Road Open
5,2,7,71.42857142857143,0,2,2,0.0,Laslo Djere,Kamil Majchrzak,Laslo Djere,Great Ocean Road Open
1,3,4,25.0,0,2,2,0.0,Albert Ramos,Albert Ramos,Blake Mott,Murray River Open
0,0,0,,0,0,0,,Blake Mott,Albert Ramos,Blake Mott,Murray River Open
0,0,0,,0,0,0,,Botic van de Zandschulp,Botic van de Zandschulp,Tristan Schoolkate,Great Ocean Road Open
0,0,0,,0,0,0,,Tristan Schoolkate,Botic van de Zandschulp,Tristan Schoolkate,Great Ocean Road Open
2,4,6,33.333333333333336,1,3,4,25.0,Corentin Moutet,Corentin Moutet,Frances Tiafoe,Murray River Open
6,4,10,60.0,6,3,9,66.66666666666667,Frances Tiafoe,Corentin Moutet,Frances Tiafoe,Murray River Open
0,0,0,,0,0,0,,Sergiy Stakhovsky,Sergiy Stakhovsky,Roman Safiullin,Great Ocean Road Open
1,1,2,50.0,1,1,2,50.0,Roman Safiullin,Sergiy Stakhovsky,Roman Safiullin,Great Ocean Road Open
0,3,3,0.0,0,3,3,0.0,James Duckworth,James Duckworth,Tomas Machac,Murray River Open
0,0,0,,0,0,0,,Tomas Machac,James Duckworth,Tomas Machac,Murray River Open
0,0,0,,0,0,0,,Aleksandar Vukic,Aleksandar Vukic,Yen Hsun Lu,Great Ocean Road Open
0,0,0,,0,0,0,,Yen Hsun Lu,Aleksandar Vukic,Yen Hsun Lu,Great Ocean Road Open
1,2,3,33.333333333333336,1,2,3,33.333333333333336,Yuichi Sugita,Yuichi Sugita,Quentin Halys,Murray River Open
0,0,0,,0,0,0,,Quentin Halys,Yuichi Sugita,Quentin Halys,Murray River Open
0,0,0,,0,0,0,,Dane Sweeny,Dane Sweeny,Ji Sung Nam,Great Ocean Road Open
0,1,1,0.0,0,1,1,0.0,Ji Sung Nam,Dane Sweeny,Ji Sung Nam,Great Ocean Road Open
4,5,9,44.44444444444444,4,5,9,44.44444444444444,Egor Gerasimov,Egor Gerasimov,Lloyd Harris,Murray River Open
4,3,7,57.142857142857146,4,3,7,57.142857142857146,Lloyd Harris,Egor Gerasimov,Lloyd Harris,Murray River Open
0,3,3,0.0,0,3,3,0.0,Aljaz Bedene,Aljaz Bedene,Yasutaka Uchiyama,Great Ocean Road Open
0,0,0,,0,0,0,,Yasutaka Uchiyama,Aljaz Bedene,Yasutaka Uchiyama,Great Ocean Road Open
0,3,3,0.0,0,3,3,0.0,Marton Fucsovics,Marton Fucsovics,Marco Cecchinato,Murray River Open
4,3,7,57.142857142857146,0,2,2,0.0,Marco Cecchinato,Marton Fucsovics,Marco Cecchinato,Murray River Open
0,4,4,0.0,0,4,4,0.0,Tennys Sandgren,Tennys Sandgren,John Patrick Smith,Great Ocean Road Open
0,0,0,,0,0,0,,John Patrick Smith,Tennys Sandgren,John Patrick Smith,Great Ocean Road Open
0,0,0,,0,0,0,,Jason Kubler,Jason Kubler,Lorenzo Sonego,Murray River Open
6,3,9,66.66666666666667,5,2,7,71.42857142857143,Lorenzo Sonego,Jason Kubler,Lorenzo Sonego,Murray River Open
2,5,7,28.571428571428573,2,4,6,33.333333333333336,Salvatore Caruso,Salvatore Caruso,Andreas Seppi,Great Ocean Road Open
1,2,3,33.333333333333336,1,1,2,50.0,Andreas Seppi,Salvatore Caruso,Andreas Seppi,Great Ocean Road Open
0,0,0,,0,0,0,,Ricardas Berankis,Ricardas Berankis,Sumit Nagal,Murray River Open
0,2,2,0.0,0,1,1,0.0,Sumit Nagal,Ricardas Berankis,Sumit Nagal,Murray River Open
0,1,1,0.0,0,1,1,0.0,Soon Woo Kwon,Soon Woo Kwon,Andrej Martin,Great Ocean Road Open
0,3,3,0.0,0,2,2,0.0,Andrej Martin,Soon Woo Kwon,Andrej Martin,Great Ocean Road Open
3,3,6,50.0,1,2,3,33.333333333333336,Jiri Vesely,Jiri Vesely,Frederico Ferreira Silva,Murray River Open
0,0,0,,0,0,0,,Frederico Ferreira Silva,Jiri Vesely,Frederico Ferreira Silva,Murray River Open
0,0,0,,0,0,0,,Christopher O'Connell,Christopher O'Connell,Dominik Koepfer,Great Ocean Road Open
0,0,0,,0,0,0,,Dominik Koepfer,Christopher O'Connell,Dominik Koepfer,Great Ocean Road Open
0,0,0,,0,0,0,,Pedro Sousa,Pedro Sousa,Li Tu,Murray River Open
0,0,0,,0,0,0,,Li Tu,Pedro Sousa,Li Tu,Murray River Open
2,4,6,33.333333333333336,2,3,5,40.0,Stefano Travaglia,Stefano Travaglia,Roberto Carballes Baena,Great Ocean Road Open
1,2,3,33.333333333333336,0,1,1,0.0,Roberto Carballes Baena,Stefano Travaglia,Roberto Carballes Baena,Great Ocean Road Open
4,3,7,57.142857142857146,4,3,7,57.142857142857146,Marcos Giron,Marcos Giron,Michael Mmoh,Murray River Open
0,0,0,,0,0,0,,Michael Mmoh,Marcos Giron,Michael Mmoh,Murray River Open
1,1,2,50.0,1,1,2,50.0,Sam Querrey,Sam Querrey,Henri Laaksonen,Great Ocean Road Open
1,1,2,50.0,1,1,2,50.0,Henri Laaksonen,Sam Querrey,Henri Laaksonen,Great Ocean Road Open
10,6,16,62.5,10,6,16,62.5,Adrian Mannarino,Adrian Mannarino,Mikael Ymer,Murray River Open
0,0,0,,0,0,0,,Mikael Ymer,Adrian Mannarino,Mikael Ymer,Murray River Open
0,1,1,0.0,0,0,0,,Pablo Cuevas,Pablo Cuevas,Pablo Andujar,Great Ocean Road Open
2,4,6,33.333333333333336,1,3,4,25.0,Pablo Andujar,Pablo Cuevas,Pablo Andujar,Great Ocean Road Open
0,0,0,,0,0,0,,Nick Kyrgios,Nick Kyrgios,Alexandre Muller,Murray River Open
0,0,0,,0,0,0,,Alexandre Muller,Nick Kyrgios,Alexandre Muller,Murray River Open
0,0,0,,0,0,0,,Robin Haase,Robin Haase,Kimmer Coppejans,Great Ocean Road Open
0,1,1,0.0,0,1,1,0.0,Kimmer Coppejans,Robin Haase,Kimmer Coppejans,Great Ocean Road Open
0,0,0,,0,0,0,,Harry Bourchier,Harry Bourchier,Marc Polmans,Murray River Open
0,1,1,0.0,0,1,1,0.0,Marc Polmans,Harry Bourchier,Marc Polmans,Murray River Open
0,0,0,,0,0,0,,Mikael Torpegaard,Mikael Torpegaard,Pedro Martinez,Great Ocean Road Open
0,0,0,,0,0,0,,Pedro Martinez,Mikael Torpegaard,Pedro Martinez,Great Ocean Road Open
4,4,8,50.0,4,4,8,50.0,Emil Ruusuvuori,Emil Ruusuvuori,Viktor Troicki,Murray River Open
0,2,2,0.0,0,2,2,0.0,Viktor Troicki,Emil Ruusuvuori,Viktor Troicki,Murray River Open
0,0,0,,0,0,0,,Mario Vilella Martinez,Mario Vilella Martinez,Yannick Hanfmann,Great Ocean Road Open
2,1,3,66.66666666666667,0,0,0,,Yannick Hanfmann,Mario Vilella Martinez,Yannick Hanfmann,Great Ocean Road Open
0,3,3,0.0,0,2,2,0.0,Federico Coria,Federico Coria,Radu Albot,Murray River Open
6,5,11,54.54545454545455,6,5,11,54.54545454545455,Radu Albot,Federico Coria,Radu Albot,Murray River Open
2,4,6,33.333333333333336,2,4,6,33.333333333333336,Pierre Hugues Herbert,Pierre Hugues Herbert,Maxime Cressy,Great Ocean Road Open
0,0,0,,0,0,0,,Maxime Cressy,Pierre Hugues Herbert,Maxime Cressy,Great Ocean Road Open
4,4,8,50.0,4,4,8,50.0,Gilles Simon,Gilles Simon,Elias Ymer,Murray River Open
0,0,0,,0,0,0,,Elias Ymer,Gilles Simon,Elias Ymer,Murray River Open
3,4,7,42.857142857142854,3,4,7,42.857142857142854,Jordan Thompson,Jordan Thompson,Gianluca Mager,Great Ocean Road Open
2,2,4,50.0,2,1,3,66.66666666666667,Gianluca Mager,Jordan Thompson,Gianluca Mager,Great Ocean Road Open
3,1,4,75.0,3,1,4,75.0,Jeremy Chardy,Jeremy Chardy,Marin Cilic,Murray River Open
3,4,7,42.857142857142854,3,4,7,42.857142857142854,Marin Cilic,Jeremy Chardy,Marin Cilic,Murray River Open
1,1,2,50.0,1,1,2,50.0,Thiago Monteiro,Thiago Monteiro,Thomas Fancutt,Great Ocean Road Open
0,0,0,,0,0,0,,Thomas Fancutt,Thiago Monteiro,Thomas Fancutt,Great Ocean Road Open
2,3,5,40.0,2,3,5,40.0,Mackenzie McDonald,Mackenzie McDonald,Richard Gasquet,Murray River Open
4,4,8,50.0,4,4,8,50.0,Richard Gasquet,Mackenzie McDonald,Richard Gasquet,Murray River Open
0,0,0,,0,0,0,,Matthew Ebden,Matthew Ebden,Federico Delbonis,Great Ocean Road Open
2,3,5,40.0,0,2,2,0.0,Federico Delbonis,Matthew Ebden,Federico Delbonis,Great Ocean Road Open
0,0,0,,0,0,0,,Alex Bolt,Alex Bolt,Thanasi Kokkinakis,Murray River Open
0,0,0,,0,0,0,,Thanasi Kokkinakis,Alex Bolt,Thanasi Kokkinakis,Murray River Open
0,0,0,,0,0,0,,Carlos Alcaraz Garfia,Carlos Alcaraz Garfia,Attila Balazs,Great Ocean Road Open
0,1,1,0.0,0,1,1,0.0,Attila Balazs,Carlos Alcaraz Garfia,Attila Balazs,Great Ocean Road Open
2,2,4,50.0,2,2,4,50.0,Mikhail Kukushkin,Mikhail Kukushkin,Juan Ignacio Londero,Murray River Open
0,0,0,,0,0,0,,Juan Ignacio Londero,Mikhail Kukushkin,Juan Ignacio Londero,Murray River Open
3,4,7,42.857142857142854,3,4,7,42.857142857142854,Karen Khachanov,Karen Khachanov,Max Purcell,Great Ocean Road Open
1,0,1,100.0,1,0,1,100.0,Max Purcell,Karen Khachanov,Max Purcell,Great Ocean Road Open
4,2,6,66.66666666666667,4,2,6,66.66666666666667,Grigor Dimitrov,Grigor Dimitrov,Andrew Harris,Murray River Open
1,0,1,100.0,1,0,1,100.0,Andrew Harris,Grigor Dimitrov,Andrew Harris,Murray River Open
5,2,7,71.42857142857143,5,2,7,71.42857142857143,Kevin Anderson,Kevin Anderson,Cedrik Marcel Stebe,Great Ocean Road Open
1,0,1,100.0,1,0,1,100.0,Cedrik Marcel Stebe,Kevin Anderson,Cedrik Marcel Stebe,Great Ocean Road Open
1,1,2,50.0,1,1,2,50.0,Alexei Popyrin,Alexei Popyrin,Tommy Paul,Murray River Open
6,5,11,54.54545454545455,5,4,9,55.55555555555556,Tommy Paul,Alexei Popyrin,Tommy Paul,Murray River Open
1,0,1,100.0,1,0,1,100.0,Botic van de Zandschulp,Botic van de Zandschulp,Kamil Majchrzak,Great Ocean Road Open
1,1,2,50.0,1,0,1,100.0,Kamil Majchrzak,Botic van de Zandschulp,Kamil Majchrzak,Great Ocean Road Open
3,4,7,42.857142857142854,2,3,5,40.0,Corentin Moutet,Corentin Moutet,Albert Ramos,Murray River Open
2,3,5,40.0,1,2,3,33.333333333333336,Albert Ramos,Corentin Moutet,Albert Ramos,Murray River Open
2,2,4,50.0,2,2,4,50.0,Reilly Opelka,Reilly Opelka,Sergiy Stakhovsky,Great Ocean Road Open
1,0,1,100.0,1,0,1,100.0,Sergiy Stakhovsky,Reilly Opelka,Sergiy Stakhovsky,Great Ocean Road Open
1,3,4,25.0,1,3,4,25.0,James Duckworth,James Duckworth,Ugo Humbert,Murray River Open
9,2,11,81.81818181818181,9,2,11,81.81818181818181,Ugo Humbert,James Duckworth,Ugo Humbert,Murray River Open
9,2,11,81.81818181818181,9,2,11,81.81818181818181,Jannik Sinner,Jannik Sinner,Aleksandar Vukic,Great Ocean Road Open
1,0,1,100.0,1,0,1,100.0,Aleksandar Vukic,Jannik Sinner,Aleksandar Vukic,Great Ocean Road Open
5,5,10,50.0,5,5,10,50.0,Felix Auger Aliassime,Felix Auger Aliassime,Yuichi Sugita,Murray River Open
2,2,4,50.0,2,2,4,50.0,Yuichi Sugita,Felix Auger Aliassime,Yuichi Sugita,Murray River Open
1,3,4,25.0,1,3,4,25.0,Aljaz Bedene,Aljaz Bedene,Dane Sweeny,Great Ocean Road Open
1,0,1,100.0,1,0,1,100.0,Dane Sweeny,Aljaz Bedene,Dane Sweeny,Great Ocean Road Open
5,5,10,50.0,5,5,10,50.0,Egor Gerasimov,Egor Gerasimov,Marton Fucsovics,Murray River Open
1,3,4,25.0,1,3,4,25.0,Marton Fucsovics,Egor Gerasimov,Marton Fucsovics,Murray River Open
3,5,8,37.5,3,4,7,42.857142857142854,Salvatore Caruso,Salvatore Caruso,Tennys Sandgren,Great Ocean Road Open
1,4,5,20.0,1,4,5,20.0,Tennys Sandgren,Salvatore Caruso,Tennys Sandgren,Great Ocean Road Open
1,0,1,100.0,1,0,1,100.0,Ricardas Berankis,Ricardas Berankis,Jason Kubler,Murray River Open
1,0,1,100.0,1,0,1,100.0,Jason Kubler,Ricardas Berankis,Jason Kubler,Murray River Open
3,5,8,37.5,3,5,8,37.5,Miomir Kecmanovic,Miomir Kecmanovic,Soon Woo Kwon,Great Ocean Road Open
1,1,2,50.0,1,1,2,50.0,Soon Woo Kwon,Miomir Kecmanovic,Soon Woo Kwon,Great Ocean Road Open
4,3,7,57.142857142857146,2,2,4,50.0,Jiri Vesely,Jiri Vesely,Casper Ruud,Murray River Open
0,3,3,0.0,0,2,2,0.0,Casper Ruud,Jiri Vesely,Casper Ruud,Murray River Open
5,4,9,55.55555555555556,5,4,9,55.55555555555556,Alexander Bublik,Alexander Bublik,Christopher O'Connell,Great Ocean Road Open
1,0,1,100.0,1,0,1,100.0,Christopher O'Connell,Alexander Bublik,Christopher O'Connell,Great Ocean Road Open
6,4,10,60.0,6,4,10,60.0,Daniel Evans,Daniel Evans,Pedro Sousa,Murray River Open
1,0,1,100.0,1,0,1,100.0,Pedro Sousa,Daniel Evans,Pedro Sousa,Murray River Open
3,4,7,42.857142857142854,3,3,6,50.0,Stefano Travaglia,Stefano Travaglia,Sam Querrey,Great Ocean Road Open
2,1,3,66.66666666666667,2,1,3,66.66666666666667,Sam Querrey,Stefano Travaglia,Sam Querrey,Great Ocean Road Open
5,3,8,62.5,5,3,8,62.5,Marcos Giron,Marcos Giron,Adrian Mannarino,Murray River Open
11,6,17,64.70588235294117,11,6,17,64.70588235294117,Adrian Mannarino,Marcos Giron,Adrian Mannarino,Murray River Open
1,1,2,50.0,1,0,1,100.0,Pablo Cuevas,Pablo Cuevas,Robin Haase,Great Ocean Road Open
1,0,1,100.0,1,0,1,100.0,Robin Haase,Pablo Cuevas,Robin Haase,Great Ocean Road Open
1,0,1,100.0,1,0,1,100.0,Nick Kyrgios,Nick Kyrgios,Harry Bourchier,Murray River Open
1,0,1,100.0,1,0,1,100.0,Harry Bourchier,Nick Kyrgios,Harry Bourchier,Murray River Open
7,3,10,70.0,7,3,10,70.0,Hubert Hurkacz,Hubert Hurkacz,Mikael Torpegaard,Great Ocean Road Open
1,0,1,100.0,1,0,1,100.0,Mikael Torpegaard,Hubert Hurkacz,Mikael Torpegaard,Great Ocean Road Open
6,3,9,66.66666666666667,6,3,9,66.66666666666667,Borna Coric,Borna Coric,Emil Ruusuvuori,Murray River Open
5,4,9,55.55555555555556,5,4,9,55.55555555555556,Emil Ruusuvuori,Borna Coric,Emil Ruusuvuori,Murray River Open
1,0,1,100.0,1,0,1,100.0,Mario Vilella Martinez,Mario Vilella Martinez,Nikoloz Basilashvili,Great Ocean Road Open
2,3,5,40.0,2,3,5,40.0,Nikoloz Basilashvili,Mario Vilella Martinez,Nikoloz Basilashvili,Great Ocean Road Open
1,4,5,20.0,1,4,5,20.0,Taylor Fritz,Taylor Fritz,Federico Coria,Murray River Open
1,3,4,25.0,1,2,3,33.333333333333336,Federico Coria,Taylor Fritz,Federico Coria,Murray River Open
4,4,8,50.0,4,4,8,50.0,Jordan Thompson,Jordan Thompson,Pierre Hugues Herbert,Great Ocean Road Open
3,4,7,42.857142857142854,3,4,7,42.857142857142854,Pierre Hugues Herbert,Jordan Thompson,Pierre Hugues Herbert,Great Ocean Road Open
4,1,5,80.0,4,1,5,80.0,Jeremy Chardy,Jeremy Chardy,Gilles Simon,Murray River Open
5,4,9,55.55555555555556,5,4,9,55.55555555555556,Gilles Simon,Jeremy Chardy,Gilles Simon,Murray River Open
2,1,3,66.66666666666667,2,1,3,66.66666666666667,Thiago Monteiro,Thiago Monteiro,Matthew Ebden,Great Ocean Road Open
1,0,1,100.0,1,0,1,100.0,Matthew Ebden,Thiago Monteiro,Matthew Ebden,Great Ocean Road Open
1,0,1,100.0,1,0,1,100.0,Alex Bolt,Alex Bolt,Mackenzie McDonald,Murray River Open
3,3,6,50.0,3,3,6,50.0,Mackenzie McDonald,Alex Bolt,Mackenzie McDonald,Murray River Open
1,0,1,100.0,1,0,1,100.0,Carlos Alcaraz Garfia,Carlos Alcaraz Garfia,David Goffin,Great Ocean Road Open
3,3,6,50.0,3,3,6,50.0,David Goffin,Carlos Alcaraz Garfia,David Goffin,Great Ocean Road Open
5,3,8,62.5,5,3,8,62.5,Stan Wawrinka,Stan Wawrinka,Mikhail Kukushkin,Murray River Open
3,2,5,60.0,3,2,5,60.0,Mikhail Kukushkin,Stan Wawrinka,Mikhail Kukushkin,Murray River Open
4,4,8,50.0,4,4,8,50.0,Karen Khachanov,Karen Khachanov,Kevin Anderson,Great Ocean Road Open
6,2,8,75.0,6,2,8,75.0,Kevin Anderson,Karen Khachanov,Kevin Anderson,Great Ocean Road Open
5,2,7,71.42857142857143,5,2,7,71.42857142857143,Grigor Dimitrov,Grigor Dimitrov,Alexei Popyrin,Murray River Open
2,1,3,66.66666666666667,2,1,3,66.66666666666667,Alexei Popyrin,Grigor Dimitrov,Alexei Popyrin,Murray River Open
2,0,2,100.0,2,0,2,100.0,Botic van de Zandschulp,Botic van de Zandschulp,Reilly Opelka,Great Ocean Road Open
3,2,5,60.0,3,2,5,60.0,Reilly Opelka,Botic van de Zandschulp,Reilly Opelka,Great Ocean Road Open
4,4,8,50.0,3,3,6,50.0,Corentin Moutet,Corentin Moutet,James Duckworth,Murray River Open
2,3,5,40.0,2,3,5,40.0,James Duckworth,Corentin Moutet,James Duckworth,Murray River Open
10,2,12,83.33333333333333,10,2,12,83.33333333333333,Jannik Sinner,Jannik Sinner,Aljaz Bedene,Great Ocean Road Open
2,3,5,40.0,2,3,5,40.0,Aljaz Bedene,Jannik Sinner,Aljaz Bedene,Great Ocean Road Open
6,5,11,54.54545454545455,6,5,11,54.54545454545455,Felix Auger Aliassime,Felix Auger Aliassime,Egor Gerasimov,Murray River Open
6,5,11,54.54545454545455,6,5,11,54.54545454545455,Egor Gerasimov,Felix Auger Aliassime,Egor Gerasimov,Murray River Open
4,5,9,44.44444444444444,4,5,9,44.44444444444444,Miomir Kecmanovic,Miomir Kecmanovic,Salvatore Caruso,Great Ocean Road Open
4,5,9,44.44444444444444,4,4,8,50.0,Salvatore Caruso,Miomir Kecmanovic,Salvatore Caruso,Great Ocean Road Open
5,3,8,62.5,3,2,5,60.0,Jiri Vesely,Jiri Vesely,Ricardas Berankis,Murray River Open
2,0,2,100.0,2,0,2,100.0,Ricardas Berankis,Jiri Vesely,Ricardas Berankis,Murray River Open
4,4,8,50.0,4,3,7,57.142857142857146,Stefano Travaglia,Stefano Travaglia,Alexander Bublik,Great Ocean Road Open
6,4,10,60.0,6,4,10,60.0,Alexander Bublik,Stefano Travaglia,Alexander Bublik,Great Ocean Road Open
7,4,11,63.63636363636363,7,4,11,63.63636363636363,Daniel Evans,Daniel Evans,Marcos Giron,Murray River Open
6,3,9,66.66666666666667,6,3,9,66.66666666666667,Marcos Giron,Daniel Evans,Marcos Giron,Murray River Open
8,3,11,72.72727272727273,8,3,11,72.72727272727273,Hubert Hurkacz,Hubert Hurkacz,Pablo Cuevas,Great Ocean Road Open
2,1,3,66.66666666666667,2,0,2,100.0,Pablo Cuevas,Hubert Hurkacz,Pablo Cuevas,Great Ocean Road Open
7,3,10,70.0,7,3,10,70.0,Borna Coric,Borna Coric,Nick Kyrgios,Murray River Open
2,0,2,100.0,2,0,2,100.0,Nick Kyrgios,Borna Coric,Nick Kyrgios,Murray River Open
5,4,9,55.55555555555556,5,4,9,55.55555555555556,Jordan Thompson,Jordan Thompson,Mario Vilella Martinez,Great Ocean Road Open
2,0,2,100.0,2,0,2,100.0,Mario Vilella Martinez,Jordan Thompson,Mario Vilella Martinez,Great Ocean Road Open
5,1,6,83.33333333333333,5,1,6,83.33333333333333,Jeremy Chardy,Jeremy Chardy,Taylor Fritz,Murray River Open
2,4,6,33.333333333333336,2,4,6,33.333333333333336,Taylor Fritz,Jeremy Chardy,Taylor Fritz,Murray River Open
3,1,4,75.0,3,1,4,75.0,Thiago Monteiro,Thiago Monteiro,Carlos Alcaraz Garfia,Great Ocean Road Open
2,0,2,100.0,2,0,2,100.0,Carlos Alcaraz Garfia,Thiago Monteiro,Carlos Alcaraz Garfia,Great Ocean Road Open
6,3,9,66.66666666666667,6,3,9,66.66666666666667,Stan Wawrinka,Stan Wawrinka,Alex Bolt,Murray River Open
2,0,2,100.0,2,0,2,100.0,Alex Bolt,Stan Wawrinka,Alex Bolt,Murray River Open
5,4,9,55.55555555555556,5,4,9,55.55555555555556,Karen Khachanov,Karen Khachanov,Botic van de Zandschulp,Great Ocean Road Open
3,0,3,100.0,3,0,3,100.0,Botic van de Zandschulp,Karen Khachanov,Botic van de Zandschulp,Great Ocean Road Open
5,4,9,55.55555555555556,4,3,7,57.142857142857146,Corentin Moutet,Corentin Moutet,Grigor Dimitrov,Murray River Open
6,2,8,75.0,6,2,8,75.0,Grigor Dimitrov,Corentin Moutet,Grigor Dimitrov,Murray River Open
11,2,13,84.61538461538461,11,2,13,84.61538461538461,Jannik Sinner,Jannik Sinner,Miomir Kecmanovic,Great Ocean Road Open
5,5,10,50.0,5,5,10,50.0,Miomir Kecmanovic,Jannik Sinner,Miomir Kecmanovic,Great Ocean Road Open
7,5,12,58.333333333333336,7,5,12,58.333333333333336,Felix Auger Aliassime,Felix Auger Aliassime,Jiri Vesely,Murray River Open
6,3,9,66.66666666666667,4,2,6,66.66666666666667,Jiri Vesely,Felix Auger Aliassime,Jiri Vesely,Murray River Open
5,4,9,55.55555555555556,5,3,8,62.5,Stefano Travaglia,Stefano Travaglia,Hubert Hurkacz,Great Ocean Road Open
9,3,12,75.0,9,3,12,75.0,Hubert Hurkacz,Stefano Travaglia,Hubert Hurkacz,Great Ocean Road Open
8,4,12,66.66666666666667,8,4,12,66.66666666666667,Daniel Evans,Daniel Evans,Borna Coric,Murray River Open
8,3,11,72.72727272727273,8,3,11,72.72727272727273,Borna Coric,Daniel Evans,Borna Coric,Murray River Open
4,1,5,80.0,4,1,5,80.0,Thiago Monteiro,Thiago Monteiro,Jordan Thompson,Great Ocean Road Open
6,4,10,60.0,6,4,10,60.0,Jordan Thompson,Thiago Monteiro,Jordan Thompson,Great Ocean Road Open
6,1,7,85.71428571428571,6,1,7,85.71428571428571,Jeremy Chardy,Jeremy Chardy,Stan Wawrinka,Murray River Open
7,3,10,70.0,7,3,10,70.0,Stan Wawrinka,Jeremy Chardy,Stan Wawrinka,Murray River Open
12,2,14,85.71428571428571,12,2,14,85.71428571428571,Jannik Sinner,Jannik Sinner,Karen Khachanov,Great Ocean Road Open
6,4,10,60.0,6,4,10,60.0,Karen Khachanov,Jannik Sinner,Karen Khachanov,Great Ocean Road Open
8,5,13,61.53846153846154,8,5,13,61.53846153846154,Felix Auger Aliassime,Felix Auger Aliassime,Corentin Moutet,Murray River Open
6,4,10,60.0,5,3,8,62.5,Corentin Moutet,Felix Auger Aliassime,Corentin Moutet,Murray River Open
6,4,10,60.0,6,3,9,66.66666666666667,Stefano Travaglia,Stefano Travaglia,Thiago Monteiro,Great Ocean Road Open
5,1,6,83.33333333333333,5,1,6,83.33333333333333,Thiago Monteiro,Stefano Travaglia,Thiago Monteiro,Great Ocean Road Open
9,4,13,69.23076923076923,9,4,13,69.23076923076923,Daniel Evans,Daniel Evans,Jeremy Chardy,Murray River Open
7,1,8,87.5,7,1,8,87.5,Jeremy Chardy,Daniel Evans,Jeremy Chardy,Murray River Open
13,2,15,86.66666666666667,13,2,15,86.66666666666667,Jannik Sinner,Jannik Sinner,Stefano Travaglia,Great Ocean Road Open
7,4,11,63.63636363636363,7,3,10,70.0,Stefano Travaglia,Jannik Sinner,Stefano Travaglia,Great Ocean Road Open
10,4,14,71.42857142857143,10,4,14,71.42857142857143,Daniel Evans,Daniel Evans,Felix Auger Aliassime,Murray River Open
9,5,14,64.28571428571429,9,5,14,64.28571428571429,Felix Auger Aliassime,Daniel Evans,Felix Auger Aliassime,Murray River Open
0,0,0,,0,0,0,,Guido Pella,Guido Pella,Yoshihito Nishioka,Atp Cup
3,2,5,60.0,3,2,5,60.0,Yoshihito Nishioka,Guido Pella,Yoshihito Nishioka,Atp Cup
5,5,10,50.0,5,5,10,50.0,Diego Schwartzman,Diego Schwartzman,Kei Nishikori,Atp Cup
0,0,0,,0,0,0,,Kei Nishikori,Diego Schwartzman,Kei Nishikori,Atp Cup
12,3,15,80.0,12,3,15,80.0,Andrey Rublev,Andrey Rublev,Yoshihito Nishioka,Atp Cup
3,3,6,50.0,3,3,6,50.0,Yoshihito Nishioka,Andrey Rublev,Yoshihito Nishioka,Atp Cup
13,2,15,86.66666666666667,13,2,15,86.66666666666667,Daniil Medvedev,Daniil Medvedev,Kei Nishikori,Atp Cup
0,1,1,0.0,0,1,1,0.0,Kei Nishikori,Daniil Medvedev,Kei Nishikori,Atp Cup
13,3,16,81.25,13,3,16,81.25,Andrey Rublev,Andrey Rublev,Guido Pella,Atp Cup
1,0,1,100.0,1,0,1,100.0,Guido Pella,Andrey Rublev,Guido Pella,Atp Cup
14,2,16,87.5,14,2,16,87.5,Daniil Medvedev,Daniil Medvedev,Diego Schwartzman,Atp Cup
6,5,11,54.54545454545455,6,5,11,54.54545454545455,Diego Schwartzman,Daniil Medvedev,Diego Schwartzman,Atp Cup
1,1,2,50.0,1,1,2,50.0,Fabio Fognini,Fabio Fognini,Benoit Paire,Atp Cup
0,2,2,0.0,0,2,2,0.0,Benoit Paire,Fabio Fognini,Benoit Paire,Atp Cup
2,2,4,50.0,2,2,4,50.0,Matteo Berrettini,Matteo Berrettini,Gael Monfils,Atp Cup
0,1,1,0.0,0,1,1,0.0,Gael Monfils,Matteo Berrettini,Gael Monfils,Atp Cup
0,0,0,,0,0,0,,Nicolas Mahut,Nicolas Mahut,Dennis Novak,Atp Cup
2,3,5,40.0,2,3,5,40.0,Dennis Novak,Nicolas Mahut,Dennis Novak,Atp Cup
5,3,8,62.5,5,3,8,62.5,Dominic Thiem,Dominic Thiem,Benoit Paire,Atp Cup
0,3,3,0.0,0,3,3,0.0,Benoit Paire,Dominic Thiem,Benoit Paire,Atp Cup
2,4,6,33.333333333333336,2,4,6,33.333333333333336,Dennis Novak,Dennis Novak,Fabio Fognini,Atp Cup
2,1,3,66.66666666666667,2,1,3,66.66666666666667,Fabio Fognini,Dennis Novak,Fabio Fognini,Atp Cup
3,2,5,60.0,3,2,5,60.0,Matteo Berrettini,Matteo Berrettini,Dominic Thiem,Atp Cup
6,3,9,66.66666666666667,6,3,9,66.66666666666667,Dominic Thiem,Matteo Berrettini,Dominic Thiem,Atp Cup
7,4,11,63.63636363636363,7,4,11,63.63636363636363,John Millman,John Millman,Michail Pervolarakis,Atp Cup
0,0,0,,0,0,0,,Michail Pervolarakis,John Millman,Michail Pervolarakis,Atp Cup
2,4,6,33.333333333333336,2,4,6,33.333333333333336,Stefanos Tsitsipas,Stefanos Tsitsipas,Alex De Minaur,Atp Cup
12,3,15,80.0,12,3,15,80.0,Alex De Minaur,Stefanos Tsitsipas,Alex De Minaur,Atp Cup
4,3,7,57.142857142857146,4,3,7,57.142857142857146,Pablo Carreno Busta,Pablo Carreno Busta,John Millman,Atp Cup
8,4,12,66.66666666666667,8,4,12,66.66666666666667,John Millman,Pablo Carreno Busta,John Millman,Atp Cup
2,1,3,66.66666666666667,2,1,3,66.66666666666667,Roberto Bautista Agut,Roberto Bautista Agut,Alex De Minaur,Atp Cup
12,4,16,75.0,12,4,16,75.0,Alex De Minaur,Roberto Bautista Agut,Alex De Minaur,Atp Cup
5,3,8,62.5,5,3,8,62.5,Pablo Carreno Busta,Pablo Carreno Busta,Michail Pervolarakis,Atp Cup
0,1,1,0.0,0,1,1,0.0,Michail Pervolarakis,Pablo Carreno Busta,Michail Pervolarakis,Atp Cup
3,4,7,42.857142857142854,3,4,7,42.857142857142854,Stefanos Tsitsipas,Stefanos Tsitsipas,Roberto Bautista Agut,Atp Cup
3,1,4,75.0,3,1,4,75.0,Roberto Bautista Agut,Stefanos Tsitsipas,Roberto Bautista Agut,Atp Cup
4,6,10,40.0,4,6,10,40.0,Jan Lennard Struff,Jan Lennard Struff,Milos Raonic,Atp Cup
9,3,12,75.0,9,3,12,75.0,Milos Raonic,Jan Lennard Struff,Milos Raonic,Atp Cup
13,3,16,81.25,13,3,16,81.25,Alexander Zverev,Alexander Zverev,Denis Shapovalov,Atp Cup
3,4,7,42.857142857142854,3,4,7,42.857142857142854,Denis Shapovalov,Alexander Zverev,Denis Shapovalov,Atp Cup
9,4,13,69.23076923076923,9,4,13,69.23076923076923,Milos Raonic,Milos Raonic,Dusan Lajovic,Atp Cup
0,4,4,0.0,0,3,3,0.0,Dusan Lajovic,Milos Raonic,Dusan Lajovic,Atp Cup
4,3,7,57.142857142857146,4,3,7,57.142857142857146,Novak Djokovic,Novak Djokovic,Denis Shapovalov,Atp Cup
3,5,8,37.5,3,5,8,37.5,Denis Shapovalov,Novak Djokovic,Denis Shapovalov,Atp Cup
5,6,11,45.45454545454545,5,6,11,45.45454545454545,Jan Lennard Struff,Jan Lennard Struff,Dusan Lajovic,Atp Cup
0,5,5,0.0,0,4,4,0.0,Dusan Lajovic,Jan Lennard Struff,Dusan Lajovic,Atp Cup
5,3,8,62.5,5,3,8,62.5,Novak Djokovic,Novak Djokovic,Alexander Zverev,Atp Cup
14,3,17,82.3529411764706,14,3,17,82.3529411764706,Alexander Zverev,Novak Djokovic,Alexander Zverev,Atp Cup
2,2,4,50.0,2,2,4,50.0,Fabio Fognini,Fabio Fognini,Pablo Carreno Busta,Atp Cup
6,3,9,66.66666666666667,6,3,9,66.66666666666667,Pablo Carreno Busta,Fabio Fognini,Pablo Carreno Busta,Atp Cup
4,2,6,66.66666666666667,4,2,6,66.66666666666667,Matteo Berrettini,Matteo Berrettini,Roberto Bautista Agut,Atp Cup
3,2,5,60.0,3,2,5,60.0,Roberto Bautista Agut,Matteo Berrettini,Roberto Bautista Agut,Atp Cup
14,3,17,82.3529411764706,14,3,17,82.3529411764706,Andrey Rublev,Andrey Rublev,Jan Lennard Struff,Atp Cup
6,6,12,50.0,6,6,12,50.0,Jan Lennard Struff,Andrey Rublev,Jan Lennard Struff,Atp Cup
15,2,17,88.23529411764706,15,2,17,88.23529411764706,Daniil Medvedev,Daniil Medvedev,Alexander Zverev,Atp Cup
14,4,18,77.77777777777777,14,4,18,77.77777777777777,Alexander Zverev,Daniil Medvedev,Alexander Zverev,Atp Cup
15,3,18,83.33333333333333,15,3,18,83.33333333333333,Andrey Rublev,Andrey Rublev,Fabio Fognini,Atp Cup
3,2,5,60.0,3,2,5,60.0,Fabio Fognini,Andrey Rublev,Fabio Fognini,Atp Cup
16,2,18,88.88888888888889,16,2,18,88.88888888888889,Daniil Medvedev,Daniil Medvedev,Matteo Berrettini,Atp Cup
5,2,7,71.42857142857143,5,2,7,71.42857142857143,Matteo Berrettini,Daniil Medvedev,Matteo Berrettini,Atp Cup
